//MAP CONVERTED BY dmm2tgm.py THIS HEADER COMMENT PREVENTS RECONVERSION, DO NOT REMOVE
"ad" = (
/turf/open/floor/rogue/dirt/road,
/area/rogue/outdoors/peaceful)
"bk" = (
/obj/structure/fluff/railing/corner,
/turf/open/floor/carpet/royalblack,
/area/rogue/indoors/peaceful)
"bQ" = (
/obj/structure/fluff/railing/border/west,
/obj/structure/fluff/railing/border/north{
	pixel_x = 3
	},
/obj/structure/fluff/railing/corner/south_east{
	pixel_y = 21;
	pixel_x = -21
	},
/turf/open/floor/carpet/royalblack,
/area/rogue/indoors/peaceful)
"bV" = (
/obj/structure/fluff/railing/corner/north_east,
/turf/closed/wall/mineral/rogue/stone,
/area/rogue/indoors/peaceful)
"cu" = (
/obj/structure/curtain/brown{
	pixel_y = -32
	},
/turf/open/floor/rogue/ruinedwood/herringbone_clear,
/area/rogue/indoors/peaceful)
"cz" = (
/obj/structure/flora/ausbushes/ywflowers,
/turf/open/floor/rogue/grassred,
/area/rogue/outdoors/woods/north)
"cB" = (
/obj/structure/flora/newtree,
/turf/open/floor/rogue/grass,
/area/rogue/outdoors/woods/north)
"dR" = (
/turf/open/floor/rogue/grassred,
/area/rogue/outdoors/woods/north)
"et" = (
/turf/open/floor/rogue/grasscold,
/area/rogue/outdoors/peaceful)
"fJ" = (
/obj/structure/globe,
/obj/machinery/light/rogue/candle/l,
/turf/open/floor/carpet/royalblack,
/area/rogue/indoors/peaceful)
"gg" = (
/turf/closed/mineral/random/rogue/high,
/area/rogue/outdoors/mountains)
"gh" = (
/obj/structure/fluff/railing/border,
/obj/machinery/light/rogue/hearth{
	pixel_y = 6
	},
/obj/machinery/light/rogue/oven/south,
/obj/item/cooking/pan,
/turf/open/floor/rogue/hexstone,
/area/rogue/indoors/peaceful)
"gk" = (
/obj/structure/flora/ausbushes/ppflowers,
/obj/structure/fluff/railing/border/north,
/turf/open/floor/rogue/grasscold,
/area/rogue/indoors/peaceful)
"gm" = (
/obj/structure/curtain/brown{
	pixel_y = 32
	},
/turf/open/floor/carpet/royalblack,
/area/rogue/indoors/peaceful)
"gF" = (
/obj/structure/flora/newtree,
/turf/open/floor/rogue/grassred,
/area/rogue/outdoors/woods/north)
"gK" = (
/obj/structure/fluff/railing/border/west,
/turf/open/floor/carpet/royalblack,
/area/rogue/indoors/peaceful)
"gQ" = (
/turf/open/floor/carpet/royalblack,
/area/rogue/indoors/peaceful)
"hd" = (
/obj/structure/mineral_door/wood,
/turf/open/floor/rogue/hexstone,
/area/rogue/indoors/peaceful)
"hN" = (
/obj/structure/bars/cemetery,
/turf/open/floor/rogue/grass,
/area/rogue/outdoors/peaceful)
"hQ" = (
/turf/open/floor/rogue/grassyel,
/area/rogue/outdoors/woods/north)
"io" = (
/turf/open/floor/rogue/dirt/road,
/area/rogue/outdoors/woods/north)
"iN" = (
/obj/structure/flora/ausbushes/ywflowers,
/turf/open/floor/rogue/grassyel,
/area/rogue/outdoors/woods/north)
"iS" = (
/obj/structure/flora/roguegrass,
/turf/open/floor/rogue/grass,
/area/rogue/outdoors/woods/north)
"jS" = (
/turf/open/floor/rogue/grass,
/area/rogue/outdoors/peaceful)
"jX" = (
/obj/structure/fluff/railing/border/north,
/obj/machinery/light/rogue/candle/l,
/turf/open/floor/carpet/royalblack,
/area/rogue/indoors/peaceful)
"kl" = (
/obj/structure/flora/newtree,
/turf/open/floor/rogue/grassyel,
/area/rogue/outdoors/woods/north)
"ky" = (
/obj/structure/flora/ausbushes/ywflowers,
/obj/structure/flora/ausbushes/brflowers,
/turf/open/floor/rogue/grasscold,
/area/rogue/outdoors/peaceful)
"lk" = (
/obj/structure/giantfur,
/turf/open/floor/rogue/ruinedwood/herringbone_clear,
/area/rogue/indoors/peaceful)
"lo" = (
/obj/structure/fluff/railing/border/west,
/obj/structure/flora/ausbushes/ywflowers,
/turf/open/floor/rogue/grasscold,
/area/rogue/indoors/peaceful)
"lI" = (
/obj/structure/fluff/walldeco/bigpainting{
	pixel_x = 2;
	pixel_y = 32
	},
/obj/machinery/light/rogue/candle/l,
/turf/open/floor/rogue/hexstone,
/area/rogue/indoors/peaceful)
"lQ" = (
/obj/structure/flora/ausbushes/ppflowers,
/turf/open/floor/rogue/grasscold,
/area/rogue/outdoors/peaceful)
"lZ" = (
/obj/structure/flora/roguegrass,
/turf/open/floor/rogue/grasscold,
/area/rogue/outdoors/peaceful)
"mh" = (
/obj/structure/flora/roguegrass/bush,
/turf/open/floor/rogue/grassyel,
/area/rogue/outdoors/woods/north)
"mN" = (
/obj/structure/bookcase/random{
	pixel_y = 6;
	pixel_x = -4
	},
/turf/open/floor/rogue/ruinedwood/herringbone_clear,
/area/rogue/indoors/peaceful)
"nA" = (
/obj/structure/chair/bench/couchablack/r,
/turf/open/floor/carpet/royalblack,
/area/rogue/indoors/peaceful)
"nB" = (
/turf/open/floor/rogue/cobble,
/area/rogue/indoors/peaceful)
"nG" = (
/turf/open/floor/rogue/hexstone,
/area/rogue/indoors/peaceful)
"nL" = (
/obj/structure/flora/roguegrass,
/turf/open/floor/rogue/grassyel,
/area/rogue/outdoors/woods/north)
"ob" = (
/obj/structure/curtain/brown{
	pixel_x = 32
	},
/turf/open/floor/rogue/hexstone,
/area/rogue/indoors/peaceful)
"oL" = (
/turf/closed/wall/mineral/rogue/stone,
/area/rogue/indoors/peaceful)
"oP" = (
/obj/structure/fluff/statue/knight/interior/r,
/turf/open/floor/rogue/ruinedwood/herringbone_clear,
/area/rogue/indoors/peaceful)
"pm" = (
/obj/structure/chair/bench/couchablack,
/turf/open/floor/carpet/royalblack,
/area/rogue/indoors/peaceful)
"qn" = (
/obj/structure/table/wood/long_table/right,
/obj/structure/mirror,
/turf/open/floor/carpet/royalblack,
/area/rogue/indoors/peaceful)
"qy" = (
/obj/structure/curtain/brown{
	pixel_x = 32
	},
/turf/open/floor/carpet/royalblack,
/area/rogue/indoors/peaceful)
"rt" = (
/obj/structure/table/wood/long_table/right,
/obj/structure/fermentation_keg/water{
	icon_state = "barrel_tapless_ready";
	pixel_x = 9;
	pixel_y = 11
	},
/obj/structure/rack/rogue/shelf,
/turf/open/floor/rogue/hexstone,
/area/rogue/indoors/peaceful)
"rv" = (
/obj/machinery/light/rogue/lanternpost,
/turf/open/floor/rogue/grasscold,
/area/rogue/outdoors/peaceful)
"rZ" = (
/obj/structure/fluff/railing/border/west,
/obj/structure/flora/ausbushes/ppflowers,
/turf/open/floor/rogue/grasscold,
/area/rogue/indoors/peaceful)
"sR" = (
/obj/structure/chair/wood/rogue{
	dir = 8
	},
/turf/open/floor/carpet/royalblack,
/area/rogue/indoors/peaceful)
"th" = (
/obj/structure/fluff/statue/small,
/turf/open/floor/rogue/grassred,
/area/rogue/outdoors/woods/north)
"tT" = (
/obj/structure/fluff/railing/corner/south_west,
/obj/structure/flora/ausbushes/ywflowers,
/turf/open/floor/rogue/grasscold,
/area/rogue/indoors/peaceful)
"uk" = (
/obj/structure/chair/bench/church{
	dir = 1
	},
/turf/open/floor/rogue/grasscold,
/area/rogue/outdoors/peaceful)
"uv" = (
/obj/structure/fluff/statue/femalestatue2{
	pixel_y = 0
	},
/turf/open/floor/rogue/dirt/road,
/area/rogue/outdoors/peaceful)
"vd" = (
/obj/structure/flora/ausbushes/ywflowers,
/turf/open/floor/rogue/grass,
/area/rogue/outdoors/woods/north)
"vF" = (
/obj/structure/flora/newtree,
/turf/open/floor/rogue/grasscold,
/area/rogue/outdoors/peaceful)
"vM" = (
/obj/item/reagent_containers/food/snacks/egg,
/obj/item/reagent_containers/food/snacks/egg,
/obj/item/reagent_containers/food/snacks/egg,
/obj/item/reagent_containers/food/snacks/grown/wheat,
/obj/item/reagent_containers/food/snacks/grown/wheat,
/obj/item/reagent_containers/food/snacks/butter,
/obj/item/reagent_containers/food/snacks/rogue/meat/sausage,
/obj/item/reagent_containers/food/snacks/rogue/meat/steak,
/obj/item/reagent_containers/food/snacks/grown/cabbage/rogue,
/obj/item/reagent_containers/food/snacks/grown/potato/rogue,
/obj/structure/closet/crate/chest,
/turf/open/floor/carpet/royalblack,
/area/rogue/indoors/peaceful)
"vR" = (
/obj/structure/curtain/brown{
	pixel_x = -32
	},
/turf/open/floor/carpet/royalblack,
/area/rogue/indoors/peaceful)
"wc" = (
/obj/structure/fluff/railing/corner,
/obj/structure/flora/ausbushes/ppflowers,
/turf/open/floor/rogue/grasscold,
/area/rogue/indoors/peaceful)
"wv" = (
/obj/structure/fluff/walldeco/bigpainting/lake,
/turf/open/floor/rogue/hexstone,
/area/rogue/indoors/peaceful)
"wI" = (
/obj/structure/rack/rogue/shelf,
/turf/open/floor/rogue/cobble,
/area/rogue/indoors/peaceful)
"wY" = (
/obj/machinery/light/rogue/candle,
/obj/structure/chair/wood/rogue/chair4{
	dir = 4
	},
/turf/open/floor/rogue/ruinedwood/herringbone,
/area/rogue/indoors/peaceful)
"yj" = (
/turf/open/floor/rogue/ruinedwood/herringbone,
/area/rogue/indoors/peaceful)
"yG" = (
/obj/structure/chair/bench/church/r,
/turf/open/floor/rogue/grasscold,
/area/rogue/outdoors/peaceful)
"yH" = (
/obj/structure/roguemachine/withdraw{
	pixel_x = 32;
	pixel_y = 0
	},
/turf/open/floor/rogue/hexstone,
/area/rogue/indoors/peaceful)
"yQ" = (
/obj/structure/fluff/railing/border{
	pixel_y = -2
	},
/obj/structure/mineral_door/wood,
/turf/open/floor/rogue/ruinedwood/herringbone,
/area/rogue/indoors/peaceful)
"yW" = (
/obj/structure/mineral_door/bars,
/turf/open/floor/rogue/grass,
/area/rogue/outdoors/peaceful)
"yZ" = (
/obj/structure/fluff/railing/border/east,
/turf/closed/wall/mineral/rogue/stone,
/area/rogue/indoors/peaceful)
"zR" = (
/obj/structure/table/wood/long_table,
/obj/structure/mirror,
/turf/open/floor/carpet/royalblack,
/area/rogue/indoors/peaceful)
"zW" = (
/obj/structure/flora/roguegrass,
/turf/open/floor/rogue/grassred,
/area/rogue/outdoors/woods/north)
"Bp" = (
/obj/machinery/light/rogue/candle/l,
/obj/structure/closet/crate/roguecloset/dark,
/turf/open/floor/carpet/royalblack,
/area/rogue/indoors/peaceful)
"BV" = (
/obj/machinery/light/rogue/candle/r,
/turf/open/floor/rogue/hexstone,
/area/rogue/indoors/peaceful)
"Cp" = (
/obj/machinery/light/rogue/candle/l,
/turf/open/floor/rogue/ruinedwood/herringbone_clear,
/area/rogue/indoors/peaceful)
"Dc" = (
/obj/structure/mineral_door/wood,
/turf/open/floor/rogue/ruinedwood/herringbone,
/area/rogue/indoors/peaceful)
"Dv" = (
/obj/machinery/light/rogue/candle/r,
/obj/structure/fluff/walldeco/painting{
	pixel_y = 32
	},
/turf/open/floor/carpet/royalblack,
/area/rogue/indoors/peaceful)
"DT" = (
/turf/closed/mineral/random/rogue/med,
/area/rogue/outdoors/mountains)
"Ef" = (
/obj/machinery/light/rogue/candle/r,
/turf/open/floor/rogue/ruinedwood/herringbone_clear,
/area/rogue/indoors/peaceful)
"EM" = (
/obj/structure/stairs{
	dir = 1
	},
/turf/open/floor/rogue/hexstone,
/area/rogue/indoors/peaceful)
"EV" = (
/obj/structure/flora/ausbushes/ppflowers,
/turf/open/floor/rogue/grassyel,
/area/rogue/outdoors/woods/north)
"Fh" = (
/obj/structure/table/wood/long_table/right,
/obj/item/rogueweapon/huntingknife/scissors,
/obj/structure/curtain/brown{
	pixel_y = -32
	},
/turf/open/floor/carpet/royalblack,
/area/rogue/indoors/peaceful)
"Ft" = (
/obj/structure/bars/cemetery,
/turf/open/floor/rogue/grassyel,
/area/rogue/outdoors/peaceful)
"FD" = (
/obj/machinery/light/rogue/candle/r,
/turf/open/floor/carpet/royalblack,
/area/rogue/indoors/peaceful)
"HB" = (
/obj/structure/bookcase/random{
	pixel_y = 6;
	pixel_x = 3
	},
/obj/machinery/light/rogue/candle/l,
/turf/open/floor/rogue/ruinedwood/herringbone_clear,
/area/rogue/indoors/peaceful)
"Ie" = (
/obj/structure/flora/roguegrass/herb/random,
/turf/open/floor/rogue/grasscold,
/area/rogue/outdoors/peaceful)
"It" = (
/obj/structure/fluff/statue/small,
/turf/open/floor/rogue/grass,
/area/rogue/outdoors/woods/north)
"Jb" = (
/obj/structure/stairs/helper{
	dir = 1
	},
/turf/open/floor/carpet/royalblack,
/area/rogue/indoors/peaceful)
"Jc" = (
/obj/structure/flora/roguegrass/bush,
/turf/open/floor/rogue/grass,
/area/rogue/outdoors/woods/north)
"JZ" = (
/obj/structure/table/wood/fancy,
/obj/structure/curtain/brown{
	pixel_x = -32
	},
/turf/open/floor/carpet/royalblack,
/area/rogue/indoors/peaceful)
"Kf" = (
/obj/structure/flora/ausbushes/brflowers,
/turf/open/floor/rogue/grasscold,
/area/rogue/outdoors/peaceful)
"KJ" = (
/obj/structure/flora/ausbushes/brflowers,
/turf/open/floor/rogue/grassred,
/area/rogue/outdoors/woods/north)
"KN" = (
/obj/machinery/light/rogue/lanternpost,
/obj/structure/flora/roguegrass,
/turf/open/floor/rogue/grasscold,
/area/rogue/outdoors/peaceful)
"LV" = (
/obj/structure/bed/rogue/inn/double,
/obj/item/bedsheet/rogue/fabric_double,
/obj/structure/curtain/brown{
	pixel_y = 32
	},
/turf/open/floor/carpet/royalblack,
/area/rogue/indoors/peaceful)
"LZ" = (
/obj/structure/fluff/statue/knight/interior,
/turf/open/floor/rogue/ruinedwood/herringbone_clear,
/area/rogue/indoors/peaceful)
"Ms" = (
/turf/closed/wall/mineral/rogue/stone,
/area/rogue/outdoors/peaceful)
"MD" = (
/obj/structure/flora/ausbushes/ppflowers,
/obj/structure/flora/ausbushes/brflowers,
/turf/open/floor/rogue/grasscold,
/area/rogue/outdoors/peaceful)
"MG" = (
/obj/structure/bars/cemetery,
/turf/open/floor/rogue/dirt/road,
/area/rogue/outdoors/peaceful)
"Nl" = (
/obj/structure/flora/ausbushes/ppflowers,
/turf/open/floor/rogue/grass,
/area/rogue/outdoors/woods/north)
"No" = (
/turf/closed/wall/mineral/rogue/wooddark/window{
	max_integrity = 99000
	},
/area/rogue/indoors/peaceful)
"NU" = (
/obj/structure/flora/ausbushes/ywflowers,
/obj/structure/flora/ausbushes/ppflowers,
/turf/open/floor/rogue/grasscold,
/area/rogue/outdoors/peaceful)
"NX" = (
/obj/structure/table/wood/long_table,
/obj/item/reagent_containers/glass/bucket/pot,
/obj/structure/rack/rogue/shelf,
/obj/item/kitchen/spoon{
	pixel_y = 26;
	pixel_x = -10
	},
/obj/item/kitchen/spoon{
	pixel_y = 26;
	pixel_x = -7
	},
/obj/item/kitchen/fork{
	pixel_y = 26
	},
/obj/item/kitchen/fork{
	pixel_y = 26;
	pixel_x = 3
	},
/turf/open/floor/rogue/hexstone,
/area/rogue/indoors/peaceful)
"OE" = (
/obj/machinery/light/rogue/lanternpost{
	dir = 1
	},
/turf/open/floor/rogue/grasscold,
/area/rogue/outdoors/peaceful)
"PM" = (
/obj/structure/mineral_door/bars,
/turf/open/floor/rogue/dirt/road,
/area/rogue/outdoors/peaceful)
"Qa" = (
/turf/open/floor/rogue/ruinedwood/herringbone_clear,
/area/rogue/indoors/peaceful)
"Qd" = (
/obj/structure/mineral_door/wood,
/turf/open/floor/rogue/tile/harem,
/area/rogue/indoors/peaceful)
"Qk" = (
/obj/machinery/light/rogue/candle/l,
/turf/open/floor/carpet/royalblack,
/area/rogue/indoors/peaceful)
"Rb" = (
/obj/structure/curtain/brown{
	pixel_x = -32
	},
/turf/open/floor/rogue/hexstone,
/area/rogue/indoors/peaceful)
"Se" = (
/obj/machinery/light/rogue/candle{
	pixel_y = -32
	},
/obj/structure/chair/wood/rogue/chair4{
	dir = 4
	},
/turf/open/floor/rogue/ruinedwood/herringbone,
/area/rogue/indoors/peaceful)
"SB" = (
/obj/structure/fluff/railing/border{
	dir = 1;
	pixel_y = 2
	},
/obj/structure/mineral_door/wood,
/turf/open/floor/rogue/ruinedwood/herringbone,
/area/rogue/indoors/peaceful)
"Tt" = (
/turf/open/transparent/openspace,
/area/rogue/indoors/peaceful)
"TK" = (
/obj/structure/flora/ausbushes/ppflowers,
/obj/structure/flora/ausbushes/ywflowers,
/turf/open/floor/rogue/grasscold,
/area/rogue/outdoors/peaceful)
"UD" = (
/obj/machinery/light/rogue/candle/r,
/obj/structure/closet/crate/roguecloset/dark,
/turf/open/floor/rogue/hexstone,
/area/rogue/indoors/peaceful)
"UG" = (
/turf/closed/mineral/rogue/bedrock,
/area/rogue/outdoors/mountains)
"Vl" = (
/obj/structure/chair/bench/church/mid,
/turf/open/floor/rogue/dirt/road,
/area/rogue/outdoors/peaceful)
"VK" = (
/obj/structure/fluff/railing/border/west,
/obj/structure/flora/ausbushes/brflowers,
/turf/open/floor/rogue/grasscold,
/area/rogue/indoors/peaceful)
"Wp" = (
/turf/open/transparent/openspace,
/area/rogue/outdoors/mountains)
"Wt" = (
/obj/structure/table/wood/long_table,
/obj/item/natural/fur/wolf,
/obj/structure/curtain/brown{
	pixel_y = -32
	},
/turf/open/floor/carpet/royalblack,
/area/rogue/indoors/peaceful)
"WO" = (
/obj/structure/flora/roguegrass/bush,
/turf/open/floor/rogue/grasscold,
/area/rogue/outdoors/peaceful)
"Xd" = (
/obj/structure/rack/rogue/shelf/biggest,
/obj/structure/rack/rogue/shelf,
/obj/item/broom,
/obj/item/reagent_containers/glass/bucket,
/obj/item/roguebin/water{
	pixel_x = -24;
	pixel_y = 16;
	anchored = 1
	},
/turf/open/floor/rogue/cobble,
/area/rogue/indoors/peaceful)
"Xy" = (
/obj/structure/fluff/railing/border,
/obj/structure/flora/ausbushes/ppflowers,
/turf/open/floor/rogue/grasscold,
/area/rogue/indoors/peaceful)
"Yv" = (
/turf/open/floor/rogue/grass,
/area/rogue/outdoors/woods/north)
"YL" = (
/obj/structure/curtain/brown{
	pixel_y = -32
	},
/turf/open/floor/carpet/royalblack,
/area/rogue/indoors/peaceful)
"Za" = (
/obj/structure/flora/roguegrass/bush,
/obj/structure/flora/roguegrass,
/turf/open/floor/rogue/grass,
/area/rogue/outdoors/woods/north)
"Zo" = (
/obj/structure/flora/ausbushes/brflowers,
/turf/open/floor/rogue/grass,
/area/rogue/outdoors/woods/north)
"ZI" = (
/obj/structure/flora/roguegrass/bush,
/obj/structure/flora/roguegrass,
/turf/open/floor/rogue/grassyel,
/area/rogue/outdoors/woods/north)

(1,1,1) = {"
hQ
kl
Yv
Yv
Yv
Yv
iS
Za
hQ
Yv
Yv
cB
iS
cB
vd
kl
cB
EV
kl
iS
Jc
"}
(2,1,1) = {"
hQ
nL
Yv
Yv
Yv
Yv
Yv
iS
cB
Yv
iS
vd
iS
Yv
iS
ZI
Yv
hQ
kl
cB
iS
"}
(3,1,1) = {"
kl
hQ
oL
oL
No
No
oL
oL
oL
No
No
oL
oL
Ft
hN
Ft
Ms
iN
nL
cB
cB
"}
(4,1,1) = {"
hQ
Yv
oL
vM
JZ
JZ
gQ
oL
HB
vR
vR
LZ
oL
ky
lQ
KN
hN
Yv
Zo
KJ
cz
"}
(5,1,1) = {"
Yv
cB
oL
wv
sR
sR
nG
oL
mN
gQ
gQ
Qa
oL
Ie
lQ
NU
Ms
hN
hN
Ms
zW
"}
(6,1,1) = {"
Yv
iS
oL
nG
nG
BV
nG
hd
gQ
gQ
gQ
YL
No
lQ
ad
TK
Ie
MD
NU
hN
gF
"}
(7,1,1) = {"
kl
Yv
oL
NX
nG
oL
oL
oL
gQ
gQ
gQ
YL
No
Kf
ad
ad
ad
lZ
uk
hN
Nl
"}
(8,1,1) = {"
hQ
Yv
oL
rt
nG
oL
LZ
Qa
Qa
gQ
gQ
Qa
oL
Ie
ad
uv
ad
ad
Vl
hN
cB
"}
(9,1,1) = {"
mh
Yv
oL
gh
yH
oL
Qa
Qa
Ef
gQ
gQ
oP
oL
Kf
ad
ad
ad
et
yG
hN
cB
"}
(10,1,1) = {"
hQ
kl
oL
oL
oL
oL
hd
oL
oL
yQ
SB
oL
oL
Ie
ad
vF
MD
TK
ky
hN
cB
"}
(11,1,1) = {"
hQ
nL
oL
oL
EM
Qk
gQ
oL
et
ad
ad
ad
ad
ad
ad
ad
et
Ie
Kf
hN
vd
"}
(12,1,1) = {"
kl
hQ
No
gK
gK
bk
YL
No
et
ad
ad
rv
et
lZ
et
lQ
et
Kf
OE
hN
cB
"}
(13,1,1) = {"
hQ
hQ
No
Qa
gQ
gQ
cu
No
lZ
ad
ad
ad
et
et
et
Ie
Ms
hN
hN
Ms
Yv
"}
(14,1,1) = {"
hQ
kl
oL
Ef
Qa
Qa
Qa
oL
lQ
et
ad
ad
ad
lQ
lZ
et
hN
Yv
Yv
iS
cB
"}
(15,1,1) = {"
nL
hQ
oL
oL
hd
oL
hd
oL
et
vF
ad
ad
ad
et
et
WO
hN
iS
vd
Zo
Nl
"}
(16,1,1) = {"
gg
dR
oL
nB
nB
oL
wI
oL
et
et
lZ
ad
ad
et
vF
lZ
hN
Yv
Zo
cB
iS
"}
(17,1,1) = {"
gg
zW
Qd
nB
nB
oL
Xd
oL
et
lQ
WO
et
ad
ad
et
et
hN
hQ
nL
cB
Yv
"}
(18,1,1) = {"
gg
gg
oL
oL
oL
oL
oL
oL
Ft
hN
Ms
PM
MG
PM
Ms
Ft
Ms
ZI
EV
cB
Nl
"}
(19,1,1) = {"
gg
gg
dR
hQ
iS
Yv
iS
Yv
Yv
Yv
hN
jS
ad
ad
hN
Yv
iS
nL
cB
cB
Yv
"}
(20,1,1) = {"
gg
gg
dR
hQ
cB
cB
cB
cB
cB
Yv
hN
ad
ad
jS
hN
nL
hQ
kl
cB
cB
cB
"}
(21,1,1) = {"
gg
gg
dR
cB
cB
cB
cB
cB
iS
Yv
Ms
yW
MG
PM
Ms
hQ
kl
cB
cB
cB
cB
"}
(22,1,1) = {"
gg
gg
dR
iS
cB
cB
cB
dR
dR
zW
th
io
io
io
It
Yv
Yv
cB
cB
cB
iS
"}
(23,1,1) = {"
DT
DT
Yv
Yv
Yv
Yv
dR
zW
mh
hQ
hQ
dR
dR
io
Yv
Yv
iS
Yv
cB
iS
Za
"}

(1,1,2) = {"
Wp
Wp
Wp
Wp
Wp
Wp
Wp
Wp
Wp
Wp
Wp
Wp
Wp
Wp
Wp
Wp
Wp
Wp
Wp
Wp
Wp
"}
(2,1,2) = {"
Wp
Wp
Wp
Wp
Wp
Wp
Wp
Wp
Wp
Wp
Wp
Wp
Wp
Wp
Wp
Wp
Wp
Wp
Wp
Wp
Wp
"}
(3,1,2) = {"
Wp
Wp
oL
oL
oL
oL
oL
oL
oL
No
No
oL
oL
Wp
Wp
Wp
Wp
Wp
Wp
Wp
Wp
"}
(4,1,2) = {"
Wp
Wp
oL
Bp
gQ
Qa
lk
oL
lI
Rb
vR
fJ
oL
Wp
Wp
Wp
Wp
Wp
Wp
Wp
Wp
"}
(5,1,2) = {"
Wp
Wp
No
LV
gQ
gQ
Qa
oL
nG
gQ
gQ
YL
No
Wp
Wp
Wp
Wp
Wp
Wp
Wp
Wp
"}
(6,1,2) = {"
Wp
Wp
oL
Dv
gQ
Qa
Qa
oL
nG
gQ
pm
Wt
No
Wp
Wp
Wp
Wp
Wp
Wp
Wp
Wp
"}
(7,1,2) = {"
Wp
Wp
oL
oL
oL
oL
Dc
oL
nG
gQ
nA
Fh
No
Wp
Wp
Wp
Wp
Wp
Wp
Wp
Wp
"}
(8,1,2) = {"
Wp
Wp
oL
zR
gQ
Cp
Qa
Dc
nG
gQ
gQ
YL
No
Wp
Wp
Wp
Wp
Wp
Wp
Wp
Wp
"}
(9,1,2) = {"
Wp
Wp
oL
qn
gQ
Qa
Qa
oL
UD
ob
qy
FD
oL
Wp
Wp
Wp
Wp
Wp
Wp
Wp
Wp
"}
(10,1,2) = {"
Wp
Wp
oL
yZ
yZ
bV
Dc
oL
oL
No
No
oL
oL
Wp
Wp
Wp
Wp
Wp
Wp
Wp
Wp
"}
(11,1,2) = {"
Wp
Wp
oL
Jb
Tt
jX
Qa
oL
Wp
Wp
Wp
Wp
Wp
Wp
Wp
Wp
Wp
Wp
Wp
Wp
Wp
"}
(12,1,2) = {"
Wp
Wp
No
gm
bQ
bk
cu
No
Wp
Wp
Wp
Wp
Wp
Wp
Wp
Wp
Wp
Wp
Wp
Wp
Wp
"}
(13,1,2) = {"
Wp
Wp
No
gm
bk
gQ
cu
No
Wp
Wp
Wp
Wp
Wp
Wp
Wp
Wp
Wp
Wp
Wp
Wp
Wp
"}
(14,1,2) = {"
Wp
Wp
oL
gQ
gQ
gQ
Qa
oL
Wp
Wp
Wp
Wp
Wp
Wp
Wp
Wp
Wp
Wp
Wp
Wp
Wp
"}
(15,1,2) = {"
Wp
Wp
oL
oL
yQ
SB
oL
oL
Wp
Wp
Wp
Wp
Wp
Wp
Wp
Wp
Wp
Wp
Wp
Wp
Wp
"}
(16,1,2) = {"
UG
Wp
oL
wY
yj
yj
Se
oL
Wp
Wp
Wp
Wp
Wp
Wp
Wp
Wp
Wp
Wp
Wp
Wp
Wp
"}
(17,1,2) = {"
UG
UG
Xy
yj
yj
yj
yj
gk
Wp
Wp
Wp
Wp
Wp
Wp
Wp
Wp
Wp
Wp
Wp
Wp
Wp
"}
(18,1,2) = {"
UG
UG
tT
VK
rZ
VK
lo
wc
Wp
Wp
Wp
Wp
Wp
Wp
Wp
Wp
Wp
Wp
Wp
Wp
Wp
"}
(19,1,2) = {"
UG
UG
Wp
Wp
Wp
Wp
Wp
Wp
Wp
Wp
Wp
Wp
Wp
Wp
Wp
Wp
Wp
Wp
Wp
Wp
Wp
"}
(20,1,2) = {"
UG
UG
Wp
Wp
Wp
Wp
Wp
Wp
Wp
Wp
Wp
Wp
Wp
Wp
Wp
Wp
Wp
Wp
Wp
Wp
Wp
"}
(21,1,2) = {"
UG
UG
Wp
Wp
Wp
Wp
Wp
Wp
Wp
Wp
Wp
Wp
Wp
Wp
Wp
Wp
Wp
Wp
Wp
Wp
Wp
"}
(22,1,2) = {"
UG
UG
Wp
Wp
Wp
Wp
Wp
Wp
Wp
Wp
Wp
Wp
Wp
Wp
Wp
Wp
Wp
Wp
Wp
Wp
Wp
"}
(23,1,2) = {"
gg
gg
gg
Wp
Wp
Wp
Wp
Wp
Wp
Wp
Wp
Wp
Wp
Wp
Wp
Wp
Wp
Wp
Wp
Wp
Wp
"}
