//MAP CONVERTED BY dmm2tgm.py THIS HEADER COMMENT PREVENTS RECONVERSION, DO NOT REMOVE
"a" = (
/turf/open/transparent/openspace,
/area/rogue/outdoors/mountains)
"c" = (
/obj/effect/landmark/quest_spawner/easy,
/turf/open/floor/rogue/grass,
/area/rogue/outdoors/woods/north)
"d" = (
/mob/living/simple_animal/hostile/retaliate/rogue/fae/sprite,
/turf/open/floor/rogue/grassyel,
/area/rogue/outdoors/woods/north)
"h" = (
/obj/structure/flora/roguegrass,
/obj/structure/flora/ausbushes/brflowers,
/turf/open/floor/rogue/grass,
/area/rogue/outdoors/woods/north)
"i" = (
/turf/open/floor/rogue/grass,
/area/rogue/outdoors/woods/north)
"j" = (
/turf/closed/mineral/rogue/bedrock,
/area/rogue/outdoors/mountains)
"n" = (
/obj/structure/flora/roguegrass,
/obj/structure/flora/ausbushes/brflowers,
/turf/open/floor/rogue/grassred,
/area/rogue/outdoors/woods/north)
"o" = (
/obj/structure/flora/roguegrass,
/turf/open/floor/rogue/dirt/road,
/area/rogue/outdoors/woods/north)
"p" = (
/mob/living/simple_animal/hostile/retaliate/rogue/fae/sprite,
/turf/open/floor/rogue/grass,
/area/rogue/outdoors/woods/north)
"q" = (
/obj/structure/flora/roguegrass/bush/wall,
/turf/open/floor/rogue/grass,
/area/rogue/outdoors/woods/north)
"u" = (
/obj/structure/flora/roguegrass,
/obj/structure/flora/ausbushes/ywflowers,
/turf/open/floor/rogue/grass,
/area/rogue/outdoors/woods/north)
"v" = (
/obj/structure/flora/newtree,
/turf/open/floor/rogue/grassyel,
/area/rogue/outdoors/woods/north)
"w" = (
/obj/structure/flora/roguegrass,
/obj/structure/flora/ausbushes/ywflowers,
/turf/open/floor/rogue/grassyel,
/area/rogue/outdoors/woods/north)
"x" = (
/obj/structure/flora/newtree,
/turf/open/floor/rogue/grassred,
/area/rogue/outdoors/woods/north)
"y" = (
/obj/structure/flora/roguegrass,
/obj/structure/flora/ausbushes/ppflowers,
/turf/open/floor/rogue/grass,
/area/rogue/outdoors/woods/north)
"A" = (
/obj/structure/flora/ausbushes/ppflowers,
/obj/structure/flora/roguegrass,
/turf/open/floor/rogue/grass,
/area/rogue/outdoors/woods/north)
"B" = (
/obj/structure/flora/roguegrass,
/turf/open/floor/rogue/grassyel,
/area/rogue/outdoors/woods/north)
"C" = (
/obj/structure/flora/newtree,
/turf/open/floor/rogue/grass,
/area/rogue/outdoors/woods/north)
"E" = (
/turf/closed/mineral/random/rogue/med,
/area/rogue/outdoors/mountains)
"F" = (
/turf/closed/mineral/random/rogue/high,
/area/rogue/outdoors/mountains)
"H" = (
/turf/open/floor/rogue/grassyel,
/area/rogue/outdoors/woods/north)
"I" = (
/obj/structure/closet/crate/chest/neu_fancy,
/obj/effect/spawner/lootdrop/general_loot_mid,
/obj/effect/spawner/lootdrop/general_loot_mid,
/turf/open/floor/rogue/grass,
/area/rogue/outdoors/woods/north)
"J" = (
/mob/living/simple_animal/hostile/retaliate/rogue/fae/glimmerwing,
/turf/open/floor/rogue/grass,
/area/rogue/outdoors/woods/north)
"K" = (
/turf/open/floor/rogue/grassred,
/area/rogue/outdoors/woods/north)
"L" = (
/obj/structure/flora/roguegrass/bush/wall,
/turf/open/floor/rogue/grassyel,
/area/rogue/outdoors/woods/north)
"M" = (
/obj/structure/flora/ausbushes/ywflowers,
/obj/structure/flora/roguegrass,
/turf/open/floor/rogue/grass,
/area/rogue/outdoors/woods/north)
"O" = (
/obj/structure/flora/roguegrass,
/turf/open/floor/rogue/grass,
/area/rogue/outdoors/woods/north)
"R" = (
/turf/open/water/cleanshallow,
/area/rogue/outdoors/woods/north)
"U" = (
/obj/structure/flora/roguegrass,
/turf/open/floor/rogue/grassred,
/area/rogue/outdoors/woods/north)
"V" = (
/obj/structure/flora/roguegrass/bush/wall,
/turf/open/floor/rogue/grassred,
/area/rogue/outdoors/woods/north)
"W" = (
/obj/structure/flora/roguegrass,
/obj/structure/flora/ausbushes/brflowers,
/turf/open/floor/rogue/grassyel,
/area/rogue/outdoors/woods/north)
"X" = (
/obj/structure/flora/ausbushes/ppflowers,
/turf/open/floor/rogue/grass,
/area/rogue/outdoors/woods/north)
"Y" = (
/obj/structure/flora/ausbushes/ppflowers,
/obj/structure/flora/roguegrass,
/turf/open/floor/rogue/grassyel,
/area/rogue/outdoors/woods/north)
"Z" = (
/obj/structure/flora/ausbushes/brflowers,
/obj/structure/flora/roguegrass,
/turf/open/floor/rogue/grassyel,
/area/rogue/outdoors/woods/north)

(1,1,1) = {"
H
H
i
i
i
C
C
C
Y
i
q
q
u
C
C
B
i
B
H
i
i
"}
(2,1,1) = {"
H
H
i
i
q
C
C
C
C
q
q
h
i
i
C
v
i
H
H
O
i
"}
(3,1,1) = {"
H
H
i
q
q
q
C
C
C
i
p
i
i
H
q
L
i
H
H
O
i
"}
(4,1,1) = {"
H
i
i
C
q
q
q
C
i
i
i
i
i
q
q
y
i
C
i
K
K
"}
(5,1,1) = {"
i
i
i
C
C
q
i
i
i
i
i
q
i
i
i
i
i
i
X
K
x
"}
(6,1,1) = {"
i
i
q
i
C
C
I
i
i
i
i
q
q
i
C
C
i
i
i
i
U
"}
(7,1,1) = {"
H
q
q
i
i
i
i
i
i
C
C
i
q
C
C
C
C
i
O
i
i
"}
(8,1,1) = {"
H
q
C
i
R
R
R
J
i
i
C
C
i
i
C
C
i
i
i
i
i
"}
(9,1,1) = {"
H
C
C
C
i
R
R
R
R
i
i
w
H
i
C
q
q
i
C
i
i
"}
(10,1,1) = {"
H
v
C
i
i
R
R
R
R
i
H
K
H
d
q
q
q
C
C
i
C
"}
(11,1,1) = {"
H
v
q
i
i
R
R
C
i
i
H
H
n
H
i
q
q
q
i
i
i
"}
(12,1,1) = {"
H
H
q
q
i
i
i
C
C
q
i
W
H
i
i
i
q
C
C
i
i
"}
(13,1,1) = {"
H
H
H
q
i
i
i
i
C
q
q
i
A
H
O
i
i
C
C
C
i
"}
(14,1,1) = {"
H
H
H
i
i
p
i
i
q
q
i
u
i
i
C
i
i
i
M
i
o
"}
(15,1,1) = {"
L
L
H
i
q
q
i
i
i
i
i
i
i
H
C
A
i
i
O
i
q
"}
(16,1,1) = {"
F
V
V
i
O
i
i
i
O
H
Z
H
i
O
q
q
i
i
O
q
q
"}
(17,1,1) = {"
F
V
V
L
i
y
q
L
H
Y
H
i
O
q
q
M
i
H
H
q
i
"}
(18,1,1) = {"
F
F
U
H
U
q
q
H
H
i
M
C
C
q
L
H
i
H
H
i
i
"}
(19,1,1) = {"
F
F
K
L
i
i
i
i
i
i
i
i
C
C
q
i
i
B
q
i
i
"}
(20,1,1) = {"
F
F
x
L
q
i
q
q
i
i
c
i
q
q
i
B
H
L
q
i
C
"}
(21,1,1) = {"
F
F
U
i
q
q
q
i
i
i
i
q
q
q
q
H
H
q
i
i
C
"}
(22,1,1) = {"
F
F
K
i
i
i
i
K
x
V
K
K
i
i
q
q
i
i
i
i
i
"}
(23,1,1) = {"
E
E
i
i
i
i
K
K
L
L
H
K
x
C
i
i
i
i
i
i
i
"}

(1,1,2) = {"
a
a
a
a
a
a
a
a
a
a
a
a
a
a
a
a
a
a
a
a
a
"}
(2,1,2) = {"
a
a
a
a
a
a
a
a
a
a
a
a
a
a
a
a
a
a
a
a
a
"}
(3,1,2) = {"
a
a
a
a
a
a
a
a
a
a
a
a
a
a
a
a
a
a
a
a
a
"}
(4,1,2) = {"
a
a
a
a
a
a
a
a
a
a
a
a
a
a
a
a
a
a
a
a
a
"}
(5,1,2) = {"
a
a
a
a
a
a
a
a
a
a
a
a
a
a
a
a
a
a
a
a
a
"}
(6,1,2) = {"
a
a
a
a
a
a
a
a
a
a
a
a
a
a
a
a
a
a
a
a
a
"}
(7,1,2) = {"
a
a
a
a
a
a
a
a
a
a
a
a
a
a
a
a
a
a
a
a
a
"}
(8,1,2) = {"
a
a
a
a
a
a
a
a
a
a
a
a
a
a
a
a
a
a
a
a
a
"}
(9,1,2) = {"
a
a
a
a
a
a
a
a
a
a
a
a
a
a
a
a
a
a
a
a
a
"}
(10,1,2) = {"
a
a
a
a
a
a
a
a
a
a
a
a
a
a
a
a
a
a
a
a
a
"}
(11,1,2) = {"
a
a
a
a
a
a
a
a
a
a
a
a
a
a
a
a
a
a
a
a
a
"}
(12,1,2) = {"
a
a
a
a
a
a
a
a
a
a
a
a
a
a
a
a
a
a
a
a
a
"}
(13,1,2) = {"
a
a
a
a
a
a
a
a
a
a
a
a
a
a
a
a
a
a
a
a
a
"}
(14,1,2) = {"
a
a
a
a
a
a
a
a
a
a
a
a
a
a
a
a
a
a
a
a
a
"}
(15,1,2) = {"
a
a
a
a
a
a
a
a
a
a
a
a
a
a
a
a
a
a
a
a
a
"}
(16,1,2) = {"
j
a
a
a
a
a
a
a
a
a
a
a
a
a
a
a
a
a
a
a
a
"}
(17,1,2) = {"
j
j
a
a
a
a
a
a
a
a
a
a
a
a
a
a
a
a
a
a
a
"}
(18,1,2) = {"
j
j
a
a
a
a
a
a
a
a
a
a
a
a
a
a
a
a
a
a
a
"}
(19,1,2) = {"
j
j
a
a
a
a
a
a
a
a
a
a
a
a
a
a
a
a
a
a
a
"}
(20,1,2) = {"
j
j
a
a
a
a
a
a
a
a
a
a
a
a
a
a
a
a
a
a
a
"}
(21,1,2) = {"
j
j
a
a
a
a
a
a
a
a
a
a
a
a
a
a
a
a
a
a
a
"}
(22,1,2) = {"
j
j
a
a
a
a
a
a
a
a
a
a
a
a
a
a
a
a
a
a
a
"}
(23,1,2) = {"
F
F
F
a
a
a
a
a
a
a
a
a
a
a
a
a
a
a
a
a
a
"}
