//MAP CONVERTED BY dmm2tgm.py THIS HEADER COMMENT PREVENTS RECONVERSION, DO NOT REMOVE
"a" = (
/obj/structure/fluff/railing/wood{
	dir = 1;
	layer = 2.7;
	pixel_y = 7
	},
/obj/structure/fluff/railing/wood{
	dir = 4;
	layer = 2.8;
	pixel_x = 8
	},
/obj/machinery/light/rogue/candle/blue{
	pixel_y = -32
	},
/turf/open/floor/rogue/greenstone/runed,
/area/rogue/outdoors/woods/southwest)
"b" = (
/turf/open/floor/rogue/greenstone/runed,
/area/rogue/outdoors/woods/southwest)
"c" = (
/turf/closed/wall/mineral/rogue/stonebrick,
/area/rogue/outdoors/woods/southwest)
"d" = (
/obj/structure/stairs/stone,
/turf/open/floor/rogue/blocks/green,
/area/rogue/outdoors/woods/southwest)
"g" = (
/obj/structure/fluff/railing/border{
	dir = 1
	},
/turf/open/transparent/openspace,
/area/rogue/outdoors/woods/southwest)
"l" = (
/obj/structure/fluff/railing/border{
	dir = 10
	},
/turf/open/transparent/openspace,
/area/rogue/outdoors/woods/southwest)
"m" = (
/obj/machinery/light/rogue/candle/blue/l,
/turf/open/floor/rogue/greenstone,
/area/rogue/outdoors/woods/southwest)
"n" = (
/obj/structure/stairs/helper{
	dir = 8
	},
/turf/open/floor/rogue/greenstone,
/area/rogue/outdoors/woods/southwest)
"p" = (
/obj/structure/fluff/railing/border{
	dir = 5
	},
/turf/open/transparent/openspace,
/area/rogue/outdoors/woods/southwest)
"q" = (
/obj/structure/stairs/helper,
/turf/open/floor/rogue/greenstone/runed,
/area/rogue/outdoors/woods/southwest)
"r" = (
/turf/open/floor/rogue/grasscold,
/area/rogue/outdoors/woods/southwest)
"u" = (
/obj/structure/fluff/railing/wood{
	pixel_y = -8
	},
/obj/structure/fluff/railing/wood{
	dir = 4;
	layer = 2.8;
	pixel_x = 8
	},
/obj/machinery/light/rogue/candle/blue,
/turf/open/floor/rogue/greenstone/runed,
/area/rogue/outdoors/woods/southwest)
"v" = (
/obj/structure/fluff/railing/border{
	dir = 6
	},
/turf/open/transparent/openspace,
/area/rogue/outdoors/woods/southwest)
"w" = (
/turf/open/transparent/openspace,
/area/rogue/outdoors/woods/southwest)
"x" = (
/obj/structure/fluff/railing/border{
	dir = 9
	},
/turf/open/transparent/openspace,
/area/rogue/outdoors/woods/southwest)
"y" = (
/turf/open/floor/rogue/greenstone/glyph5,
/area/rogue/outdoors/woods/southwest)
"z" = (
/obj/structure/wild_plant/nospread/manabloom,
/turf/open/floor/rogue/grasscold,
/area/rogue/outdoors/woods/southwest)
"A" = (
/obj/structure/fluff/railing/wood{
	pixel_y = -8
	},
/turf/open/floor/rogue/greenstone/runed,
/area/rogue/outdoors/woods/southwest)
"B" = (
/obj/structure/stairs/stone{
	dir = 1
	},
/turf/open/floor/rogue/blocks/green,
/area/rogue/outdoors/woods/southwest)
"D" = (
/obj/structure/fluff/railing/border{
	dir = 4
	},
/turf/open/transparent/openspace,
/area/rogue/outdoors/woods/southwest)
"E" = (
/obj/structure/stairs/stone{
	dir = 4
	},
/turf/open/floor/rogue/blocks/green,
/area/rogue/outdoors/woods/southwest)
"F" = (
/turf/open/floor/rogue/blocks/green,
/area/rogue/outdoors/woods/southwest)
"G" = (
/turf/open/floor/rogue/greenstone,
/area/rogue/outdoors/woods/southwest)
"I" = (
/obj/structure/stairs/helper{
	dir = 1
	},
/turf/open/floor/rogue/greenstone/runed,
/area/rogue/outdoors/woods/southwest)
"K" = (
/obj/structure/fluff/railing/wood{
	dir = 8;
	pixel_x = -10
	},
/obj/structure/fluff/railing/wood{
	dir = 8;
	pixel_x = -10
	},
/turf/open/floor/rogue/greenstone/runed,
/area/rogue/outdoors/woods/southwest)
"L" = (
/obj/structure/fluff/railing/wood{
	dir = 4;
	layer = 2.8;
	pixel_x = 8
	},
/turf/open/floor/rogue/greenstone/runed,
/area/rogue/outdoors/woods/southwest)
"M" = (
/obj/structure/stairs/stone{
	dir = 8
	},
/turf/open/floor/rogue/blocks/green,
/area/rogue/outdoors/woods/southwest)
"N" = (
/obj/structure/fluff/railing/wood{
	dir = 8;
	pixel_x = -10
	},
/turf/open/floor/rogue/greenstone/runed,
/area/rogue/outdoors/woods/southwest)
"P" = (
/obj/structure/fluff/railing/wood{
	dir = 8;
	pixel_x = -10
	},
/obj/structure/fluff/railing/wood{
	pixel_y = -8
	},
/obj/machinery/light/rogue/candle/blue,
/turf/open/floor/rogue/greenstone/runed,
/area/rogue/outdoors/woods/southwest)
"R" = (
/obj/structure/fluff/railing/wood{
	dir = 8;
	pixel_x = -10
	},
/obj/structure/fluff/railing/wood{
	dir = 1;
	pixel_y = 5
	},
/obj/machinery/light/rogue/candle/blue{
	pixel_y = -32
	},
/turf/open/floor/rogue/greenstone/runed,
/area/rogue/outdoors/woods/southwest)
"S" = (
/obj/machinery/light/rogue/candle/blue/r,
/turf/open/floor/rogue/greenstone,
/area/rogue/outdoors/woods/southwest)
"U" = (
/obj/structure/fluff/railing/border,
/turf/open/transparent/openspace,
/area/rogue/outdoors/woods/southwest)
"V" = (
/turf/open/floor/rogue/greenstone/glyph2,
/area/rogue/outdoors/woods/southwest)
"W" = (
/obj/structure/well/fountain/mana,
/obj/effect/decal/cleanable/roguerune/arcyne/summoning/mid,
/turf/open/floor/rogue/greenstone/runed,
/area/rogue/outdoors/woods/southwest)
"X" = (
/obj/structure/stairs/helper{
	dir = 4
	},
/turf/open/floor/rogue/greenstone,
/area/rogue/outdoors/woods/southwest)
"Y" = (
/obj/structure/fluff/railing/border{
	dir = 8
	},
/turf/open/transparent/openspace,
/area/rogue/outdoors/woods/southwest)
"Z" = (
/obj/structure/fluff/railing/wood{
	dir = 1;
	layer = 2.7;
	pixel_y = 7
	},
/turf/open/floor/rogue/greenstone/runed,
/area/rogue/outdoors/woods/southwest)

(1,1,1) = {"
z
r
F
b
F
z
r
"}
(2,1,1) = {"
E
c
y
L
V
c
E
"}
(3,1,1) = {"
c
c
u
w
a
c
c
"}
(4,1,1) = {"
b
A
w
w
w
Z
b
"}
(5,1,1) = {"
c
c
P
w
R
c
c
"}
(6,1,1) = {"
M
c
y
K
V
c
M
"}
(7,1,1) = {"
r
z
F
b
F
z
z
"}

(1,1,2) = {"
v
D
D
D
D
D
p
"}
(2,1,2) = {"
U
G
S
L
S
G
g
"}
(3,1,2) = {"
X
d
c
w
c
B
X
"}
(4,1,2) = {"
b
A
w
w
w
Z
b
"}
(5,1,2) = {"
n
d
c
w
c
B
n
"}
(6,1,2) = {"
U
G
m
N
m
G
g
"}
(7,1,2) = {"
l
Y
Y
Y
Y
Y
x
"}

(1,1,3) = {"
w
w
w
w
w
w
w
"}
(2,1,3) = {"
w
v
D
D
D
p
w
"}
(3,1,3) = {"
w
w
q
b
I
w
w
"}
(4,1,3) = {"
w
U
b
W
b
g
w
"}
(5,1,3) = {"
w
w
q
b
I
w
w
"}
(6,1,3) = {"
w
l
Y
Y
Y
x
w
"}
(7,1,3) = {"
w
w
w
w
w
w
w
"}
