//MAP CONVERTED BY dmm2tgm.py THIS HEADER COMMENT PREVENTS RECONVERSION, DO NOT REMOVE
"a" = (
/turf/open/transparent/openspace,
/area/rogue/outdoors/woods/southwest)
"b" = (
/turf/open/floor/rogue/grass,
/area/rogue/outdoors/woods/southwest)
"l" = (
/obj/structure/well/fountain/mana,
/turf/open/floor/rogue/greenstone,
/area/rogue/outdoors/woods/southwest)
"n" = (
/obj/structure/wild_plant/nospread/manabloom,
/turf/open/floor/rogue/grasscold,
/area/rogue/outdoors/woods/southwest)
"z" = (
/turf/open/floor/rogue/greenstone/runed,
/area/rogue/outdoors/woods/southwest)
"G" = (
/turf/open/floor/rogue/greenstone,
/area/rogue/outdoors/woods/southwest)
"K" = (
/obj/structure/wild_plant/nospread/manabloom,
/turf/open/floor/rogue/dirt,
/area/rogue/outdoors/woods/southwest)
"N" = (
/turf/open/floor/rogue/dirt,
/area/rogue/outdoors/woods/southwest)
"O" = (
/obj/structure/flora/newtree,
/turf/open/floor/rogue/grass,
/area/rogue/outdoors/woods/southwest)
"W" = (
/obj/structure/flora/newtree,
/turf/open/floor/rogue/dirt,
/area/rogue/outdoors/woods/southwest)
"Y" = (
/turf/open/floor/rogue/grasscold,
/area/rogue/outdoors/woods/southwest)

(1,1,1) = {"
Y
W
Y
K
W
O
Y
"}
(2,1,1) = {"
Y
n
n
Y
n
n
b
"}
(3,1,1) = {"
n
Y
G
z
G
Y
n
"}
(4,1,1) = {"
n
Y
z
l
z
Y
n
"}
(5,1,1) = {"
n
Y
G
z
G
Y
n
"}
(6,1,1) = {"
O
n
n
Y
n
n
b
"}
(7,1,1) = {"
N
b
N
n
N
Y
b
"}

(1,1,2) = {"
a
a
a
a
a
a
a
"}
(2,1,2) = {"
a
a
a
a
a
a
a
"}
(3,1,2) = {"
a
a
a
a
a
a
a
"}
(4,1,2) = {"
a
a
a
a
a
a
a
"}
(5,1,2) = {"
a
a
a
a
a
a
a
"}
(6,1,2) = {"
a
a
a
a
a
a
a
"}
(7,1,2) = {"
a
a
a
a
a
a
a
"}

(1,1,3) = {"
a
a
a
a
a
a
a
"}
(2,1,3) = {"
a
a
a
a
a
a
a
"}
(3,1,3) = {"
a
a
a
a
a
a
a
"}
(4,1,3) = {"
a
a
a
a
a
a
a
"}
(5,1,3) = {"
a
a
a
a
a
a
a
"}
(6,1,3) = {"
a
a
a
a
a
a
a
"}
(7,1,3) = {"
a
a
a
a
a
a
a
"}
