//MAP CONVERTED BY dmm2tgm.py THIS HEADER COMMENT PREVENTS RECONVERSION, DO NOT REMOVE
"bI" = (
/mob/living/carbon/human/species/goblin/npc,
/turf/open/floor/rogue/dirt/road,
/area/rogue/under/tomb)
"cF" = (
/turf/open/water/swamp,
/area/rogue/under/tomb)
"dI" = (
/obj/machinery/light/rogue/campfire/longlived,
/turf/open/floor/rogue/dirt,
/area/rogue/under/tomb/cave)
"ea" = (
/obj/structure/flora/roguegrass/water,
/turf/open/floor/rogue/dirt,
/area/rogue/under/tomb)
"eb" = (
/turf/open/floor/rogue/dirt,
/area/rogue/under/tomb)
"fn" = (
/obj/structure/ladder/earth,
/obj/structure/ladder/earth,
/turf/open/floor/rogue/dirt,
/area/rogue/under/tomb/cave)
"gL" = (
/mob/living/carbon/human/species/hobgoblin/npc,
/turf/open/floor/rogue/dirt,
/area/rogue/under/tomb/cave)
"mF" = (
/turf/closed/wall/mineral/rogue/tent{
	dir = 1
	},
/area/rogue/under/tomb/cave)
"mH" = (
/mob/living/carbon/human/species/hobgoblin/npc,
/turf/open/floor/rogue/naturalstone,
/area/rogue/under/tomb/cave)
"mJ" = (
/turf/closed/mineral/random/rogue/high,
/area/rogue/under/tomb/cave)
"na" = (
/obj/effect/spawner/lootdrop/general_loot_mid/x3,
/obj/structure/closet/crate/chest/wicker,
/turf/open/floor/rogue/dirt/road,
/area/rogue/under/tomb)
"ng" = (
/turf/closed/mineral/random/rogue/high,
/area/rogue/under/tomb)
"nn" = (
/turf/closed/wall/mineral/rogue/tent{
	dir = 4
	},
/area/rogue/under/tomb)
"oe" = (
/obj/effect/dungeon_directional_helper/north,
/turf/open/floor/rogue/naturalstone,
/area/rogue/under/tomb)
"ow" = (
/obj/structure/ladder/earth,
/turf/open/floor/rogue/dirt,
/area/rogue/under/tomb)
"oI" = (
/obj/machinery/light/rogue/torchholder/l,
/turf/open/floor/rogue/naturalstone,
/area/rogue/under/tomb/cave)
"oS" = (
/obj/structure/chair/stool/rogue,
/turf/open/floor/rogue/dirt,
/area/rogue/under/tomb)
"pp" = (
/obj/machinery/light/rogue/torchholder/c,
/turf/open/floor/rogue/dirt,
/area/rogue/under/tomb/cave)
"qr" = (
/turf/closed/wall/mineral/rogue/tent{
	dir = 8
	},
/area/rogue/under/tomb)
"qS" = (
/mob/living/carbon/human/species/goblin/npc,
/turf/open/floor/rogue/naturalstone,
/area/rogue/under/tomb)
"qX" = (
/obj/machinery/light/rogue/torchholder/l,
/turf/open/water/swamp,
/area/rogue/under/tomb/cave)
"rf" = (
/mob/living/carbon/human/species/goblin/npc,
/obj/structure/bed/rogue/shit,
/turf/open/floor/rogue/naturalstone,
/area/rogue/under/tomb/cave)
"sh" = (
/turf/open/floor/rogue/naturalstone,
/area/rogue/under/tomb/cave)
"sC" = (
/turf/closed/wall/mineral/rogue/wood,
/area/rogue/under/tomb)
"tp" = (
/obj/effect/dungeon_directional_helper/west,
/turf/open/floor/rogue/naturalstone,
/area/rogue/under/tomb)
"ty" = (
/turf/closed/wall/mineral/rogue/tent{
	dir = 1
	},
/area/rogue/under/tomb)
"ve" = (
/obj/structure/flora/roguegrass/water,
/turf/open/water/swamp,
/area/rogue/under/tomb)
"vw" = (
/obj/machinery/light/rogue/torchholder/r,
/turf/open/floor/rogue/naturalstone,
/area/rogue/under/tomb)
"vx" = (
/obj/structure/bed/rogue/shit,
/turf/open/floor/rogue/dirt/road,
/area/rogue/under/tomb)
"zi" = (
/obj/effect/dungeon_directional_helper/south,
/turf/open/floor/rogue/naturalstone,
/area/rogue/under/tomb)
"zo" = (
/obj/machinery/light/rogue/torchholder/l,
/turf/open/floor/rogue/naturalstone,
/area/rogue/under/tomb)
"Ax" = (
/obj/effect/spawner/lootdrop/general_loot_low/x3,
/obj/structure/closet/crate/chest/wicker,
/turf/open/floor/rogue/dirt/road,
/area/rogue/under/tomb)
"BQ" = (
/obj/machinery/light/rogue/torchholder/l,
/turf/open/floor/rogue/dirt,
/area/rogue/under/tomb/cave)
"Cu" = (
/obj/structure/roguetent,
/turf/open/floor/rogue/dirt,
/area/rogue/under/tomb/cave)
"Es" = (
/obj/machinery/light/rogue/torchholder/r,
/turf/open/floor/rogue/naturalstone,
/area/rogue/under/tomb/cave)
"Gw" = (
/turf/closed/wall/mineral/rogue/tent,
/area/rogue/under/tomb)
"Hi" = (
/turf/open/floor/rogue/naturalstone,
/area/rogue/under/tomb)
"Hn" = (
/turf/closed/wall/mineral/rogue/tent,
/area/rogue/under/tomb/cave)
"Ip" = (
/turf/closed/wall/mineral/rogue/wood,
/area/rogue/under/tomb/cave)
"Iu" = (
/turf/closed/mineral/rogue/bedrock,
/area/rogue/under/tomb/cave)
"Jf" = (
/obj/structure/roguetent,
/turf/open/floor/rogue/dirt/road,
/area/rogue/under/tomb)
"JD" = (
/obj/effect/dungeon_directional_helper/east,
/turf/open/floor/rogue/naturalstone,
/area/rogue/under/tomb)
"JE" = (
/obj/structure/roguetent,
/turf/open/floor/rogue/naturalstone,
/area/rogue/under/tomb/cave)
"LG" = (
/mob/living/carbon/human/species/hobgoblin/npc,
/turf/open/floor/rogue/dirt/road,
/area/rogue/under/tomb)
"Nf" = (
/turf/open/water/swamp,
/area/rogue/under/tomb/cave)
"Ns" = (
/mob/living/carbon/human/species/goblin/npc,
/turf/open/floor/rogue/dirt,
/area/rogue/under/tomb/cave)
"OG" = (
/obj/item/reagent_containers/food/snacks/rogue/meat/sausage{
	pixel_x = 6;
	pixel_y = 4
	},
/obj/item/grown/log/tree/stake,
/turf/open/floor/rogue/dirt,
/area/rogue/under/tomb)
"Pg" = (
/turf/closed/wall/mineral/rogue/tent{
	dir = 8
	},
/area/rogue/under/tomb/cave)
"PN" = (
/turf/open/floor/rogue/dirt,
/area/rogue/under/tomb/cave)
"Qu" = (
/mob/living/carbon/human/species/goblin/npc,
/turf/open/floor/rogue/naturalstone,
/area/rogue/under/tomb/cave)
"Ri" = (
/turf/closed/wall/mineral/rogue/tent{
	dir = 4
	},
/area/rogue/under/tomb/cave)
"Rw" = (
/obj/machinery/light/rogue/torchholder/l,
/turf/open/water/swamp,
/area/rogue/under/tomb)
"RG" = (
/mob/living/carbon/human/species/goblin/npc,
/obj/structure/bed/rogue/shit,
/turf/open/floor/rogue/dirt,
/area/rogue/under/tomb/cave)
"RT" = (
/obj/machinery/light/rogue/torchholder/c,
/turf/open/floor/rogue/naturalstone,
/area/rogue/under/tomb)
"Sy" = (
/turf/closed/mineral/rogue/bedrock,
/area/rogue/under/tomb)
"SG" = (
/obj/machinery/light/rogue/torchholder/c,
/turf/open/floor/rogue/dirt,
/area/rogue/under/tomb)
"SP" = (
/turf/open/floor/rogue/dirt/road,
/area/rogue/under/tomb)
"VW" = (
/obj/machinery/light/rogue/torchholder/r,
/turf/open/floor/rogue/dirt,
/area/rogue/under/tomb)
"Yn" = (
/obj/machinery/light/rogue/torchholder/r,
/turf/open/floor/rogue/dirt,
/area/rogue/under/tomb/cave)
"Zg" = (
/mob/living/carbon/human/species/hobgoblin/npc,
/turf/open/floor/rogue/naturalstone,
/area/rogue/under/tomb)
"Zl" = (
/obj/machinery/light/rogue/campfire/longlived,
/turf/open/floor/rogue/dirt,
/area/rogue/under/tomb)
"Zt" = (
/mob/living/carbon/human/species/goblin/npc,
/turf/open/floor/rogue/dirt,
/area/rogue/under/tomb)
"ZQ" = (
/turf/open/transparent/openspace,
/area/rogue/under/tomb/cave)

(1,1,1) = {"
Sy
Sy
Sy
Sy
Sy
Sy
Sy
Sy
Sy
Sy
Sy
Hi
tp
Hi
Sy
Sy
Sy
Sy
Sy
Sy
Sy
Sy
Sy
Sy
"}
(2,1,1) = {"
Sy
ng
ng
ng
ng
ng
ng
ng
ng
ng
ng
ng
Hi
ng
ng
ng
ng
ng
ng
ng
ng
ng
ng
Sy
"}
(3,1,1) = {"
Sy
ng
ng
ng
ng
cF
cF
cF
cF
ng
Hi
Hi
Hi
ng
ng
cF
cF
cF
ng
ng
ng
ng
ng
Sy
"}
(4,1,1) = {"
Sy
ng
ng
ng
cF
cF
Hi
Hi
Hi
Hi
Hi
ng
Hi
ng
ng
cF
cF
cF
cF
ng
ng
ng
ng
Sy
"}
(5,1,1) = {"
Sy
ng
ng
eb
ng
Hi
sC
nn
nn
nn
nn
sC
Hi
zo
Hi
eb
Hi
ea
cF
ng
ng
ng
ng
Sy
"}
(6,1,1) = {"
Sy
ng
ng
cF
Hi
Hi
Gw
na
vx
SP
bI
ty
Hi
Hi
Hi
ng
Hi
ng
cF
Rw
ng
ng
ng
Sy
"}
(7,1,1) = {"
Sy
ng
ng
ve
ng
ng
Gw
SP
SP
LG
SP
Jf
eb
ng
eb
Hi
Hi
Hi
eb
eb
cF
ng
ng
Sy
"}
(8,1,1) = {"
Sy
ng
ng
cF
eb
ng
Gw
vx
bI
SP
SP
Jf
eb
eb
OG
eb
eb
qS
Hi
ea
eb
cF
ng
Sy
"}
(9,1,1) = {"
Sy
ng
ng
ng
eb
ng
Gw
SP
SP
Ax
SP
ty
eb
Zl
oS
eb
ng
Hi
Hi
ng
eb
ng
ng
Sy
"}
(10,1,1) = {"
Sy
ng
cF
cF
ea
eb
sC
qr
qr
qr
qr
sC
eb
OG
eb
eb
ea
Hi
Hi
Hi
Hi
Hi
Hi
Sy
"}
(11,1,1) = {"
Hi
ng
ng
ng
eb
eb
eb
Zg
Hi
Hi
Hi
ng
ng
SG
cF
eb
Hi
Zg
Hi
Hi
Hi
ng
RT
Hi
"}
(12,1,1) = {"
oe
Hi
Hi
Hi
Hi
Hi
Hi
Hi
ng
Hi
Hi
ng
ow
eb
cF
ng
Hi
ng
Hi
Hi
Hi
Hi
Hi
zi
"}
(13,1,1) = {"
Hi
ng
ng
eb
eb
eb
ng
Hi
Hi
Hi
Hi
ng
eb
ng
Hi
eb
ea
Hi
Hi
ng
Hi
Hi
Hi
Hi
"}
(14,1,1) = {"
Sy
ng
ng
ve
eb
VW
eb
Hi
eb
Hi
Hi
eb
eb
eb
ng
eb
eb
vw
Hi
Hi
Hi
Hi
Hi
Sy
"}
(15,1,1) = {"
Sy
ng
ng
ng
eb
ng
ea
Hi
sC
nn
Jf
sC
eb
eb
OG
eb
eb
ng
Hi
Zt
eb
ng
Hi
Sy
"}
(16,1,1) = {"
Sy
ng
ng
ng
cF
ng
eb
ng
Gw
vx
SP
ty
eb
oS
Zl
ng
eb
eb
eb
eb
ea
cF
ng
Sy
"}
(17,1,1) = {"
Sy
ng
ng
ng
ng
cF
eb
eb
Gw
Ax
LG
ty
eb
ea
oS
eb
ea
ng
ng
eb
cF
ng
ng
Sy
"}
(18,1,1) = {"
Sy
ng
ng
ng
ng
cF
cF
ng
sC
qr
qr
sC
eb
eb
ng
cF
cF
Hi
ng
eb
cF
ng
ng
Sy
"}
(19,1,1) = {"
Sy
ng
ng
ng
ng
ng
cF
cF
ng
eb
Hi
Hi
Hi
eb
cF
ng
ng
eb
sC
Jf
nn
sC
ng
Sy
"}
(20,1,1) = {"
Sy
ng
ng
ng
ng
ng
ng
cF
eb
ea
eb
ng
Hi
ng
ng
ng
ng
cF
Gw
SP
Ax
ty
ng
Sy
"}
(21,1,1) = {"
Sy
ng
ng
ng
ng
ng
ng
ng
ng
ng
cF
ng
Hi
ng
ng
ng
ng
ng
Gw
bI
vx
ty
ng
Sy
"}
(22,1,1) = {"
Sy
ng
ng
ng
ng
ng
ng
ng
ng
ng
ng
ng
Hi
ng
ng
ng
ng
ng
sC
qr
qr
sC
ng
Sy
"}
(23,1,1) = {"
Sy
ng
ng
ng
ng
ng
ng
ng
ng
ng
ng
ng
Hi
ng
ng
ng
ng
ng
ng
ng
ng
ng
ng
Sy
"}
(24,1,1) = {"
Sy
Sy
Sy
Sy
Sy
Sy
Sy
Sy
Sy
Sy
Sy
Hi
JD
Hi
Sy
Sy
Sy
Sy
Sy
Sy
Sy
Sy
Sy
Sy
"}

(1,1,2) = {"
Iu
Iu
Iu
Iu
Iu
Iu
Iu
Iu
Iu
Iu
Iu
sh
sh
PN
Iu
Iu
Iu
Iu
Iu
Iu
Iu
Iu
Iu
Iu
"}
(2,1,2) = {"
Iu
mJ
mJ
mJ
mJ
mJ
mJ
mJ
mJ
mJ
mJ
sh
sh
sh
mJ
mJ
mJ
mJ
mJ
mJ
mJ
mJ
mJ
Iu
"}
(3,1,2) = {"
Iu
mJ
mJ
mJ
mJ
mJ
mJ
mJ
mJ
mJ
mJ
sh
sh
sh
BQ
Nf
Nf
mJ
mJ
mJ
mJ
mJ
mJ
Iu
"}
(4,1,2) = {"
Iu
mJ
mJ
mJ
mJ
mJ
Nf
Nf
Nf
mJ
mJ
PN
mJ
sh
PN
PN
Nf
Nf
mJ
mJ
mJ
mJ
mJ
Iu
"}
(5,1,2) = {"
Iu
mJ
mJ
mJ
mJ
mJ
Nf
PN
PN
PN
PN
sh
PN
sh
PN
PN
Nf
mJ
mJ
mJ
mJ
mJ
mJ
Iu
"}
(6,1,2) = {"
Iu
mJ
mJ
mJ
mJ
qX
PN
PN
mJ
mJ
pp
sh
Qu
sh
mJ
Ip
Ri
Ri
Ri
Ip
mJ
mJ
mJ
Iu
"}
(7,1,2) = {"
Iu
mJ
mJ
mJ
mJ
sh
PN
sh
sh
sh
PN
PN
PN
sh
PN
Hn
sh
sh
gL
mF
Nf
mJ
mJ
Iu
"}
(8,1,2) = {"
Iu
mJ
mJ
mJ
mJ
sh
sh
Ip
Ri
Ri
Ip
PN
PN
gL
sh
JE
PN
mJ
sh
mF
Nf
Nf
mJ
Iu
"}
(9,1,2) = {"
Iu
mJ
mJ
mJ
mJ
Nf
PN
Hn
RG
PN
mF
PN
dI
PN
PN
Hn
PN
PN
rf
mF
Nf
Nf
mJ
Iu
"}
(10,1,2) = {"
ZQ
mJ
mJ
mJ
mJ
Nf
PN
Hn
PN
PN
Cu
PN
PN
PN
PN
Ip
Pg
Pg
Pg
Ip
sh
sh
PN
Iu
"}
(11,1,2) = {"
PN
PN
mJ
mJ
mJ
Nf
PN
Ip
Pg
Pg
Ip
PN
PN
mJ
Nf
sh
sh
PN
PN
mJ
mJ
sh
sh
sh
"}
(12,1,2) = {"
sh
PN
PN
PN
mJ
Nf
PN
sh
sh
sh
sh
mJ
fn
PN
sh
PN
mJ
sh
PN
mJ
PN
sh
sh
sh
"}
(13,1,2) = {"
sh
sh
mJ
PN
PN
mJ
PN
sh
sh
sh
sh
mJ
mJ
sh
PN
Nf
mJ
sh
sh
sh
Es
sh
sh
PN
"}
(14,1,2) = {"
ZQ
sh
Es
sh
sh
PN
PN
sh
mJ
sh
sh
mJ
oI
sh
sh
sh
sh
sh
sh
sh
mJ
PN
mJ
Iu
"}
(15,1,2) = {"
Iu
mJ
mJ
PN
sh
sh
sh
sh
Ns
PN
PN
PN
PN
PN
Ns
sh
mJ
PN
PN
sh
PN
Nf
mJ
Iu
"}
(16,1,2) = {"
Iu
mJ
mJ
mJ
PN
PN
sh
sh
sh
PN
mJ
PN
PN
PN
mJ
sh
PN
PN
PN
Nf
mJ
mJ
mJ
Iu
"}
(17,1,2) = {"
Iu
mJ
mJ
mJ
mJ
Nf
Nf
Nf
sh
sh
mH
PN
mJ
PN
sh
sh
PN
PN
Nf
mJ
mJ
mJ
mJ
Iu
"}
(18,1,2) = {"
Iu
mJ
mJ
mJ
mJ
mJ
mJ
Nf
Nf
sh
sh
sh
PN
PN
sh
sh
Yn
Nf
mJ
mJ
mJ
mJ
mJ
Iu
"}
(19,1,2) = {"
Iu
mJ
mJ
mJ
mJ
mJ
mJ
mJ
mJ
Nf
sh
sh
PN
mJ
sh
mJ
mJ
mJ
mJ
mJ
mJ
mJ
mJ
Iu
"}
(20,1,2) = {"
Iu
mJ
mJ
mJ
mJ
mJ
mJ
mJ
mJ
Nf
Nf
sh
PN
sh
sh
mJ
mJ
mJ
mJ
mJ
mJ
mJ
mJ
Iu
"}
(21,1,2) = {"
Iu
mJ
mJ
mJ
mJ
mJ
mJ
mJ
mJ
mJ
PN
sh
mJ
sh
PN
mJ
mJ
mJ
mJ
mJ
mJ
mJ
mJ
Iu
"}
(22,1,2) = {"
Iu
mJ
mJ
mJ
mJ
mJ
mJ
mJ
mJ
mJ
Es
sh
sh
sh
mJ
mJ
mJ
mJ
mJ
mJ
mJ
mJ
mJ
Iu
"}
(23,1,2) = {"
Iu
mJ
mJ
mJ
mJ
mJ
mJ
mJ
mJ
mJ
mJ
sh
sh
sh
mJ
mJ
mJ
mJ
mJ
mJ
mJ
mJ
mJ
Iu
"}
(24,1,2) = {"
Iu
Iu
Iu
Iu
Iu
Iu
Iu
Iu
Iu
Iu
Iu
PN
sh
sh
Iu
Iu
Iu
Iu
Iu
Iu
Iu
Iu
Iu
Iu
"}
