//MAP CONVERTED BY dmm2tgm.py THIS HEADER COMMENT PREVENTS RECONVERSION, DO NOT REMOVE
"bV" = (
/mob/living/carbon/human/species/hobgoblin/npc,
/turf/open/floor/rogue/naturalstone,
/area/rogue/under/tomb)
"ek" = (
/obj/machinery/light/rogue/torchholder/c,
/turf/open/floor/rogue/naturalstone,
/area/rogue/under/tomb)
"eU" = (
/obj/item/reagent_containers/food/snacks/rogue/meat/sausage{
	pixel_x = 6;
	pixel_y = 4
	},
/obj/item/grown/log/tree/stake,
/turf/open/floor/rogue/dirt,
/area/rogue/under/tomb)
"gd" = (
/turf/closed/wall/mineral/rogue/tent{
	dir = 4
	},
/area/rogue)
"gx" = (
/obj/machinery/light/rogue/torchholder/l,
/turf/open/floor/rogue/naturalstone,
/area/rogue/under/tomb)
"gE" = (
/turf/closed/wall/mineral/rogue/tent{
	dir = 1
	},
/area/rogue)
"iP" = (
/turf/closed/wall/mineral/rogue/tent{
	dir = 1
	},
/area/rogue/under/tomb)
"iW" = (
/mob/living/carbon/human/species/goblin/npc,
/turf/open/floor/rogue/naturalstone,
/area/rogue/under/tomb)
"jK" = (
/turf/closed/mineral/random/rogue/high,
/area/rogue/under/tomb)
"jQ" = (
/obj/structure/chair/stool/rogue,
/turf/open/floor/rogue/dirt,
/area/rogue/under/tomb)
"kg" = (
/turf/open/water/swamp,
/area/rogue)
"lC" = (
/obj/effect/dungeon_directional_helper/east,
/turf/open/floor/rogue/naturalstone,
/area/rogue/under/tomb)
"lE" = (
/obj/structure/bed/rogue/shit,
/turf/open/floor/rogue/dirt/road,
/area/rogue/under/tomb)
"lW" = (
/mob/living/carbon/human/species/hobgoblin/npc,
/turf/open/floor/rogue/dirt,
/area/rogue)
"nl" = (
/turf/closed/wall/mineral/rogue/tent,
/area/rogue)
"nA" = (
/obj/effect/dungeon_directional_helper/south,
/turf/open/floor/rogue/naturalstone,
/area/rogue/under/tomb)
"oV" = (
/mob/living/carbon/human/species/goblin/npc,
/obj/structure/bed/rogue/shit,
/turf/open/floor/rogue/dirt,
/area/rogue)
"oW" = (
/turf/closed/wall/mineral/rogue/wood,
/area/rogue)
"pQ" = (
/turf/open/floor/rogue/dirt/road,
/area/rogue/under/tomb)
"qA" = (
/mob/living/carbon/human/species/hobgoblin/npc,
/turf/open/floor/rogue/naturalstone,
/area/rogue)
"rZ" = (
/obj/structure/ladder/earth,
/obj/structure/ladder/earth,
/turf/open/floor/rogue/dirt,
/area/rogue)
"tj" = (
/obj/effect/dungeon_directional_helper/west,
/turf/open/floor/rogue/naturalstone,
/area/rogue/under/tomb)
"tG" = (
/obj/structure/roguetent,
/turf/open/floor/rogue/naturalstone,
/area/rogue)
"ui" = (
/turf/closed/mineral/rogue/bedrock,
/area/rogue)
"ve" = (
/mob/living/carbon/human/species/goblin/npc,
/turf/open/floor/rogue/dirt,
/area/rogue)
"vy" = (
/turf/open/floor/rogue/dirt,
/area/rogue)
"wd" = (
/obj/machinery/light/rogue/torchholder/l,
/turf/open/water/swamp,
/area/rogue/under/tomb)
"wr" = (
/turf/open/water/swamp,
/area/rogue/under/tomb)
"wL" = (
/obj/effect/dungeon_directional_helper/north,
/turf/open/floor/rogue/naturalstone,
/area/rogue/under/tomb)
"xU" = (
/obj/machinery/light/rogue/torchholder/l,
/turf/open/floor/rogue/dirt,
/area/rogue)
"xZ" = (
/obj/machinery/light/rogue/torchholder/r,
/turf/open/floor/rogue/dirt,
/area/rogue/under/tomb)
"yV" = (
/mob/living/carbon/human/species/hobgoblin/npc,
/turf/open/floor/rogue/dirt/road,
/area/rogue/under/tomb)
"zC" = (
/turf/closed/wall/mineral/rogue/tent{
	dir = 4
	},
/area/rogue/under/tomb)
"Aq" = (
/turf/open/floor/rogue/naturalstone,
/area/rogue)
"BT" = (
/mob/living/carbon/human/species/goblin/npc,
/turf/open/floor/rogue/dirt/road,
/area/rogue/under/tomb)
"Cf" = (
/turf/closed/mineral/rogue/bedrock,
/area/rogue/under/tomb)
"CQ" = (
/obj/machinery/light/rogue/torchholder/r,
/turf/open/floor/rogue/naturalstone,
/area/rogue)
"CV" = (
/obj/machinery/light/rogue/torchholder/c,
/turf/open/floor/rogue/dirt,
/area/rogue/under/tomb)
"Dd" = (
/turf/open/floor/rogue/dirt,
/area/rogue/under/tomb)
"DQ" = (
/obj/machinery/light/rogue/campfire/longlived,
/turf/open/floor/rogue/dirt,
/area/rogue/under/tomb)
"GJ" = (
/obj/structure/ladder/earth,
/turf/open/floor/rogue/dirt,
/area/rogue/under/tomb)
"GW" = (
/turf/closed/wall/mineral/rogue/tent,
/area/rogue/under/tomb)
"HK" = (
/turf/open/floor/rogue/naturalstone,
/area/rogue/under/tomb)
"Jw" = (
/turf/closed/wall/mineral/rogue/wood,
/area/rogue/under/tomb)
"JI" = (
/obj/structure/roguetent,
/turf/open/floor/rogue/dirt,
/area/rogue)
"JO" = (
/turf/open/transparent/openspace,
/area/rogue)
"KV" = (
/obj/structure/flora/roguegrass/water,
/turf/open/floor/rogue/dirt,
/area/rogue/under/tomb)
"Lh" = (
/obj/effect/spawner/lootdrop/general_loot_mid/x3,
/obj/structure/closet/crate/chest/wicker,
/turf/open/floor/rogue/dirt/road,
/area/rogue/under/tomb)
"Lx" = (
/obj/machinery/light/rogue/torchholder/l,
/turf/open/floor/rogue/naturalstone,
/area/rogue)
"LE" = (
/obj/structure/flora/roguegrass/water,
/turf/open/water/swamp,
/area/rogue/under/tomb)
"LI" = (
/obj/machinery/light/rogue/torchholder/l,
/turf/open/water/swamp,
/area/rogue)
"Mf" = (
/obj/effect/spawner/lootdrop/general_loot_low/x3,
/obj/structure/closet/crate/chest/wicker,
/turf/open/floor/rogue/dirt/road,
/area/rogue/under/tomb)
"MM" = (
/obj/machinery/light/rogue/campfire/longlived,
/turf/open/floor/rogue/dirt,
/area/rogue)
"Pl" = (
/obj/machinery/light/rogue/torchholder/c,
/turf/open/floor/rogue/dirt,
/area/rogue)
"Qc" = (
/turf/closed/mineral/random/rogue/high,
/area/rogue)
"RO" = (
/turf/closed/wall/mineral/rogue/tent{
	dir = 8
	},
/area/rogue/under/tomb)
"Ug" = (
/obj/machinery/light/rogue/torchholder/r,
/turf/open/floor/rogue/naturalstone,
/area/rogue/under/tomb)
"Uu" = (
/mob/living/carbon/human/species/goblin/npc,
/turf/open/floor/rogue/dirt,
/area/rogue/under/tomb)
"VE" = (
/obj/machinery/light/rogue/torchholder/r,
/turf/open/floor/rogue/dirt,
/area/rogue)
"VG" = (
/obj/structure/roguetent,
/turf/open/floor/rogue/dirt/road,
/area/rogue/under/tomb)
"Xe" = (
/mob/living/carbon/human/species/goblin/npc,
/obj/structure/bed/rogue/shit,
/turf/open/floor/rogue/naturalstone,
/area/rogue)
"XT" = (
/mob/living/carbon/human/species/goblin/npc,
/turf/open/floor/rogue/naturalstone,
/area/rogue)
"ZE" = (
/turf/closed/wall/mineral/rogue/tent{
	dir = 8
	},
/area/rogue)

(1,1,1) = {"
Cf
Cf
Cf
Cf
Cf
Cf
Cf
Cf
Cf
Cf
Cf
HK
tj
HK
Cf
Cf
Cf
Cf
Cf
Cf
Cf
Cf
Cf
Cf
"}
(2,1,1) = {"
Cf
jK
jK
jK
jK
jK
jK
jK
jK
jK
jK
jK
HK
jK
jK
jK
jK
jK
jK
jK
jK
jK
jK
Cf
"}
(3,1,1) = {"
Cf
jK
jK
jK
jK
wr
wr
wr
wr
jK
HK
HK
HK
jK
jK
wr
wr
wr
jK
jK
jK
jK
jK
Cf
"}
(4,1,1) = {"
Cf
jK
jK
jK
wr
wr
HK
HK
HK
HK
HK
jK
HK
jK
jK
wr
wr
wr
wr
jK
jK
jK
jK
Cf
"}
(5,1,1) = {"
Cf
jK
jK
Dd
jK
HK
Jw
zC
zC
zC
zC
Jw
HK
gx
HK
Dd
HK
KV
wr
jK
jK
jK
jK
Cf
"}
(6,1,1) = {"
Cf
jK
jK
wr
HK
HK
GW
Lh
lE
pQ
BT
iP
HK
HK
HK
jK
HK
jK
wr
wd
jK
jK
jK
Cf
"}
(7,1,1) = {"
Cf
jK
jK
LE
jK
jK
GW
pQ
pQ
yV
pQ
VG
Dd
jK
Dd
HK
HK
HK
Dd
Dd
wr
jK
jK
Cf
"}
(8,1,1) = {"
Cf
jK
jK
wr
Dd
jK
GW
lE
BT
pQ
pQ
VG
Dd
Dd
eU
Dd
Dd
iW
HK
KV
Dd
wr
jK
Cf
"}
(9,1,1) = {"
Cf
jK
jK
jK
Dd
jK
GW
pQ
pQ
Mf
pQ
iP
Dd
DQ
jQ
Dd
jK
HK
HK
jK
Dd
jK
jK
Cf
"}
(10,1,1) = {"
Cf
jK
wr
wr
KV
Dd
Jw
RO
RO
RO
RO
Jw
Dd
eU
Dd
Dd
KV
HK
HK
HK
HK
HK
HK
Cf
"}
(11,1,1) = {"
HK
jK
jK
jK
Dd
Dd
Dd
bV
HK
HK
HK
jK
jK
CV
wr
Dd
HK
bV
HK
HK
HK
jK
ek
HK
"}
(12,1,1) = {"
wL
HK
HK
HK
HK
HK
HK
HK
jK
HK
HK
jK
GJ
Dd
wr
jK
HK
jK
HK
HK
HK
HK
HK
nA
"}
(13,1,1) = {"
HK
jK
jK
Dd
Dd
Dd
jK
HK
HK
HK
HK
jK
Dd
jK
HK
Dd
KV
HK
HK
jK
HK
HK
HK
HK
"}
(14,1,1) = {"
Cf
jK
jK
LE
Dd
xZ
Dd
HK
Dd
HK
HK
Dd
Dd
Dd
jK
Dd
Dd
Ug
HK
HK
HK
HK
HK
Cf
"}
(15,1,1) = {"
Cf
jK
jK
jK
Dd
jK
KV
HK
Jw
zC
VG
Jw
Dd
Dd
eU
Dd
Dd
jK
HK
Uu
Dd
jK
HK
Cf
"}
(16,1,1) = {"
Cf
jK
jK
jK
wr
jK
Dd
jK
GW
lE
pQ
iP
Dd
jQ
DQ
jK
Dd
Dd
Dd
Dd
KV
wr
jK
Cf
"}
(17,1,1) = {"
Cf
jK
jK
jK
jK
wr
Dd
Dd
GW
Mf
yV
iP
Dd
KV
jQ
Dd
KV
jK
jK
Dd
wr
jK
jK
Cf
"}
(18,1,1) = {"
Cf
jK
jK
jK
jK
wr
wr
jK
Jw
RO
RO
Jw
Dd
Dd
jK
wr
wr
HK
jK
Dd
wr
jK
jK
Cf
"}
(19,1,1) = {"
Cf
jK
jK
jK
jK
jK
wr
wr
jK
Dd
HK
HK
HK
Dd
wr
jK
jK
Dd
Jw
VG
zC
Jw
jK
Cf
"}
(20,1,1) = {"
Cf
jK
jK
jK
jK
jK
jK
wr
Dd
KV
Dd
jK
HK
jK
jK
jK
jK
wr
GW
pQ
Mf
iP
jK
Cf
"}
(21,1,1) = {"
Cf
jK
jK
jK
jK
jK
jK
jK
jK
jK
wr
jK
HK
jK
jK
jK
jK
jK
GW
BT
lE
iP
jK
Cf
"}
(22,1,1) = {"
Cf
jK
jK
jK
jK
jK
jK
jK
jK
jK
jK
jK
HK
jK
jK
jK
jK
jK
Jw
RO
RO
Jw
jK
Cf
"}
(23,1,1) = {"
Cf
jK
jK
jK
jK
jK
jK
jK
jK
jK
jK
jK
HK
jK
jK
jK
jK
jK
jK
jK
jK
jK
jK
Cf
"}
(24,1,1) = {"
Cf
Cf
Cf
Cf
Cf
Cf
Cf
Cf
Cf
Cf
Cf
HK
lC
HK
Cf
Cf
Cf
Cf
Cf
Cf
Cf
Cf
Cf
Cf
"}

(1,1,2) = {"
ui
ui
ui
ui
ui
ui
ui
ui
ui
ui
ui
Aq
Aq
vy
ui
ui
ui
ui
ui
ui
ui
ui
ui
ui
"}
(2,1,2) = {"
ui
Qc
Qc
Qc
Qc
Qc
Qc
Qc
Qc
Qc
Qc
Aq
Aq
Aq
Qc
Qc
Qc
Qc
Qc
Qc
Qc
Qc
Qc
ui
"}
(3,1,2) = {"
ui
Qc
Qc
Qc
Qc
Qc
Qc
Qc
Qc
Qc
Qc
Aq
Aq
Aq
xU
kg
kg
Qc
Qc
Qc
Qc
Qc
Qc
ui
"}
(4,1,2) = {"
ui
Qc
Qc
Qc
Qc
Qc
kg
kg
kg
Qc
Qc
vy
Qc
Aq
vy
vy
kg
kg
Qc
Qc
Qc
Qc
Qc
ui
"}
(5,1,2) = {"
ui
Qc
Qc
Qc
Qc
Qc
kg
vy
vy
vy
vy
Aq
vy
Aq
vy
vy
kg
Qc
Qc
Qc
Qc
Qc
Qc
ui
"}
(6,1,2) = {"
ui
Qc
Qc
Qc
Qc
LI
vy
vy
Qc
Qc
Pl
Aq
XT
Aq
Qc
oW
gd
gd
gd
oW
Qc
Qc
Qc
ui
"}
(7,1,2) = {"
ui
Qc
Qc
Qc
Qc
Aq
vy
Aq
Aq
Aq
vy
vy
vy
Aq
vy
nl
Aq
Aq
lW
gE
kg
Qc
Qc
ui
"}
(8,1,2) = {"
ui
Qc
Qc
Qc
Qc
Aq
Aq
oW
gd
gd
oW
vy
vy
lW
Aq
tG
vy
Qc
Aq
gE
kg
kg
Qc
ui
"}
(9,1,2) = {"
ui
Qc
Qc
Qc
Qc
kg
vy
nl
oV
vy
gE
vy
MM
vy
vy
nl
vy
vy
Xe
gE
kg
kg
Qc
ui
"}
(10,1,2) = {"
JO
Qc
Qc
Qc
Qc
kg
vy
nl
vy
vy
JI
vy
vy
vy
vy
oW
ZE
ZE
ZE
oW
Aq
Aq
vy
ui
"}
(11,1,2) = {"
vy
vy
Qc
Qc
Qc
kg
vy
oW
ZE
ZE
oW
vy
vy
Qc
kg
Aq
Aq
vy
vy
Qc
Qc
Aq
Aq
Aq
"}
(12,1,2) = {"
Aq
vy
vy
vy
Qc
kg
vy
Aq
Aq
Aq
Aq
Qc
rZ
vy
Aq
vy
Qc
Aq
vy
Qc
vy
Aq
Aq
Aq
"}
(13,1,2) = {"
Aq
Aq
Qc
vy
vy
Qc
vy
Aq
Aq
Aq
Aq
Qc
Qc
Aq
vy
kg
Qc
Aq
Aq
Aq
CQ
Aq
Aq
vy
"}
(14,1,2) = {"
JO
Aq
CQ
Aq
Aq
vy
vy
Aq
Qc
Aq
Aq
Qc
Lx
Aq
Aq
Aq
Aq
Aq
Aq
Aq
Qc
vy
Qc
ui
"}
(15,1,2) = {"
ui
Qc
Qc
vy
Aq
Aq
Aq
Aq
ve
vy
vy
vy
vy
vy
ve
Aq
Qc
vy
vy
Aq
vy
kg
Qc
ui
"}
(16,1,2) = {"
ui
Qc
Qc
Qc
vy
vy
Aq
Aq
Aq
vy
Qc
vy
vy
vy
Qc
Aq
vy
vy
vy
kg
Qc
Qc
Qc
ui
"}
(17,1,2) = {"
ui
Qc
Qc
Qc
Qc
kg
kg
kg
Aq
Aq
qA
vy
Qc
vy
Aq
Aq
vy
vy
kg
Qc
Qc
Qc
Qc
ui
"}
(18,1,2) = {"
ui
Qc
Qc
Qc
Qc
Qc
Qc
kg
kg
Aq
Aq
Aq
vy
vy
Aq
Aq
VE
kg
Qc
Qc
Qc
Qc
Qc
ui
"}
(19,1,2) = {"
ui
Qc
Qc
Qc
Qc
Qc
Qc
Qc
Qc
kg
Aq
Aq
vy
Qc
Aq
Qc
Qc
Qc
Qc
Qc
Qc
Qc
Qc
ui
"}
(20,1,2) = {"
ui
Qc
Qc
Qc
Qc
Qc
Qc
Qc
Qc
kg
kg
Aq
vy
Aq
Aq
Qc
Qc
Qc
Qc
Qc
Qc
Qc
Qc
ui
"}
(21,1,2) = {"
ui
Qc
Qc
Qc
Qc
Qc
Qc
Qc
Qc
Qc
vy
Aq
Qc
Aq
vy
Qc
Qc
Qc
Qc
Qc
Qc
Qc
Qc
ui
"}
(22,1,2) = {"
ui
Qc
Qc
Qc
Qc
Qc
Qc
Qc
Qc
Qc
CQ
Aq
Aq
Aq
Qc
Qc
Qc
Qc
Qc
Qc
Qc
Qc
Qc
ui
"}
(23,1,2) = {"
ui
Qc
Qc
Qc
Qc
Qc
Qc
Qc
Qc
Qc
Qc
Aq
Aq
Aq
Qc
Qc
Qc
Qc
Qc
Qc
Qc
Qc
Qc
ui
"}
(24,1,2) = {"
ui
ui
ui
ui
ui
ui
ui
ui
ui
ui
ui
vy
Aq
Aq
ui
ui
ui
ui
ui
ui
ui
ui
ui
ui
"}
