//MAP CONVERTED BY dmm2tgm.py THIS HEADER COMMENT PREVENTS RECONVERSION, DO NOT REMOVE
"bw" = (
/obj/effect/decal/cleanable/blood/footprints/mud{
	dir = 8
	},
/turf/open/floor/rogue/blocks/stonered/tiny,
/area/rogue/indoors)
"cI" = (
/obj/structure/closet/crate/chest/neu,
/turf/open/floor/rogue/blocks/stonered/tiny,
/area/rogue/indoors)
"dk" = (
/turf/closed/mineral/random/rogue/high,
/area/rogue/under/cavewet/bogcaves/north)
"dU" = (
/obj/item/reagent_containers/food/snacks/crow{
	dir = 8;
	pixel_y = 12;
	pixel_x = 6
	},
/turf/open/floor/rogue/rooftop/green/north,
/area/rogue/outdoors/town/roofs)
"ea" = (
/obj/structure/bed/rogue{
	dir = 8
	},
/turf/open/floor/rogue/blocks/stonered/tiny,
/area/rogue/indoors)
"em" = (
/mob/living/carbon/human/species/skeleton/npc/supereasy,
/turf/open/floor/rogue/blocks/stonered/tiny,
/area/rogue/indoors)
"eJ" = (
/turf/open/transparent/openspace,
/area/rogue/outdoors/mountains)
"fg" = (
/obj/structure/table/wood/map,
/obj/effect/decal/cleanable/dirt/cobweb{
	dir = 1
	},
/turf/open/floor/rogue/blocks/stonered/tiny,
/area/rogue/indoors)
"fi" = (
/obj/structure/mineral_door/wood/deadbolt{
	dir = 8;
	locked = 1;
	name = "rotting door";
	color = "#778079"
	},
/turf/open/floor/rogue/blocks/stonered/tiny,
/area/rogue/indoors)
"fL" = (
/obj/effect/decal/cleanable/dirt/cobweb{
	dir = 8
	},
/turf/open/floor/rogue/blocks/stonered/tiny,
/area/rogue/indoors)
"fN" = (
/obj/item/seeds/wheat,
/turf/open/floor/rogue/rooftop/green/north,
/area/rogue/outdoors/town/roofs)
"fV" = (
/obj/structure/table/wood/map/six,
/obj/item/ash,
/obj/item/cigbutt/roach{
	pixel_y = 1;
	pixel_x = -6
	},
/turf/open/floor/rogue/blocks/stonered/tiny,
/area/rogue/indoors)
"fW" = (
/obj/structure/flora/roguegrass/bush,
/turf/open/floor/rogue/grass,
/area/rogue/outdoors/woods/south)
"gb" = (
/obj/effect/decal/cleanable/blood/footprints/mud,
/obj/effect/decal/cleanable/blood/footprints/mud{
	dir = 8
	},
/turf/open/floor/rogue/blocks/stonered/tiny,
/area/rogue/indoors)
"gn" = (
/obj/structure/rack/rogue,
/obj/effect/spawner/lootdrop/general_loot_low,
/turf/open/floor/rogue/blocks/stonered/tiny,
/area/rogue/indoors)
"gp" = (
/turf/closed/wall/mineral/rogue/wooddark/end/east,
/area/rogue/indoors)
"gr" = (
/turf/open/floor/rogue/naturalstone,
/area/rogue/under/cavewet/bogcaves/north)
"gN" = (
/obj/item/chair/stool/bar/rogue,
/turf/open/floor/rogue/blocks/stonered/tiny,
/area/rogue/indoors)
"hB" = (
/turf/open/floor/rogue/dirt/road,
/area/rogue/outdoors/woods/south)
"iN" = (
/obj/item/reagent_containers/glass/cup/wooden,
/obj/structure/table/wood/poor,
/turf/open/floor/rogue/blocks/stonered/tiny,
/area/rogue/indoors)
"iU" = (
/obj/structure/mineral_door/wood/deadbolt{
	color = "#778079";
	dir = 1;
	max_integrity = 500;
	name = "rotting door"
	},
/turf/open/floor/rogue/blocks/stonered,
/area/rogue/indoors)
"iV" = (
/obj/structure/closet/crate/chest/wicker,
/obj/effect/decal/cleanable/dirt/cobweb{
	dir = 1
	},
/turf/open/floor/rogue/blocks/stonered/tiny,
/area/rogue/indoors)
"jY" = (
/obj/structure/mineral_door/wood/deadbolt{
	dir = 8;
	locked = 1;
	name = "rotting door";
	color = "#778079";
	max_integrity = 500
	},
/turf/open/floor/rogue/blocks/stonered,
/area/rogue/indoors)
"kj" = (
/obj/machinery/light/rogue/candle,
/obj/effect/decal/cleanable/dirt/cobweb{
	dir = 8
	},
/turf/open/floor/rogue/blocks/stonered/tiny,
/area/rogue/indoors)
"kk" = (
/obj/structure/bed/rogue{
	dir = 8
	},
/mob/living/carbon/human/species/skeleton/npc/supereasy,
/turf/open/floor/rogue/blocks/stonered/tiny,
/area/rogue/indoors)
"kn" = (
/obj/item/reagent_containers/food/snacks/crow,
/turf/open/floor/rogue/rooftop/green/north,
/area/rogue/outdoors/town/roofs)
"kA" = (
/obj/structure/rack/rogue,
/obj/item/storage/belt/rogue/pouch/zigarrete,
/turf/open/floor/rogue/blocks/stonered/tiny,
/area/rogue/indoors)
"lH" = (
/obj/machinery/light/rogue/candle/weak/l,
/turf/open/floor/rogue/blocks/stonered/tiny,
/area/rogue/indoors)
"mA" = (
/turf/open/floor/rogue/twig,
/area/rogue/indoors)
"mF" = (
/obj/structure/fluff/railing/border/west{
	dir = 10
	},
/turf/open/floor/rogue/grass,
/area/rogue/outdoors/woods/south)
"ne" = (
/obj/structure/closet/crate/chest/wicker,
/turf/open/floor/rogue/blocks/stonered/tiny,
/area/rogue/indoors)
"nt" = (
/obj/structure/fluff/railing/wood/north{
	pixel_y = 1
	},
/turf/open/floor/rogue/twig,
/area/rogue/indoors)
"nU" = (
/obj/structure/flora/roguegrass/bush/westleach,
/turf/open/floor/rogue/grass,
/area/rogue/outdoors/woods/south)
"ow" = (
/obj/structure/wallladder,
/turf/open/transparent/openspace,
/area/rogue/outdoors/mountains)
"pb" = (
/obj/structure/stairs{
	dir = 1
	},
/turf/open/floor/rogue/twig,
/area/rogue/indoors)
"pr" = (
/obj/machinery/light/rogue/candle/weak/r,
/turf/open/floor/rogue/blocks/stonered/tiny,
/area/rogue/indoors)
"pt" = (
/obj/structure/table/wood/map/three,
/obj/effect/decal/cleanable/debris/woody,
/turf/open/floor/rogue/blocks/stonered/tiny,
/area/rogue/indoors)
"qN" = (
/obj/item/reagent_containers/food/snacks/crow{
	dir = 8
	},
/turf/open/floor/rogue/rooftop/green/north,
/area/rogue/outdoors/town/roofs)
"qQ" = (
/obj/structure/table/wood/map/four,
/obj/effect/decal/cleanable/dirt/cobweb{
	dir = 8
	},
/obj/effect/decal/cleanable/debris/woody,
/obj/effect/decal/cleanable/debris/stony,
/turf/open/floor/rogue/blocks/stonered/tiny,
/area/rogue/indoors)
"ro" = (
/obj/structure/fluff/railing/border/west{
	dir = 4
	},
/turf/open/floor/rogue/grass,
/area/rogue/outdoors/woods/south)
"rw" = (
/obj/machinery/light/rogue/candle/r,
/obj/structure/closet/crate/chest/wicker,
/obj/effect/decal/cleanable/debris/stony,
/turf/open/floor/rogue/blocks/stonered/tiny,
/area/rogue/indoors)
"rx" = (
/obj/structure/bed/rogue{
	dir = 8
	},
/obj/effect/decal/cleanable/dirt/cobweb,
/turf/open/floor/rogue/blocks/stonered/tiny,
/area/rogue/indoors)
"su" = (
/turf/open/floor/rogue/grass,
/area/rogue/outdoors/woods/south)
"tH" = (
/obj/machinery/light/rogue/candle/r,
/turf/open/floor/rogue/blocks/stonered/tiny,
/area/rogue/indoors)
"vl" = (
/turf/closed/wall/mineral/rogue/stonebrick,
/area/rogue/indoors)
"vB" = (
/obj/item/reagent_containers/food/snacks/crow{
	dir = 1
	},
/turf/open/floor/rogue/rooftop/green/north,
/area/rogue/outdoors/town/roofs)
"vP" = (
/turf/closed/wall/mineral/rogue/wooddark/end,
/area/rogue/indoors)
"wk" = (
/obj/machinery/light/rogue/candle/l,
/obj/effect/decal/cleanable/dirt/cobweb,
/turf/open/floor/rogue/blocks/stonered/tiny,
/area/rogue/indoors)
"wu" = (
/obj/structure/chair/wood/rogue/chair4{
	dir = 1
	},
/turf/open/floor/rogue/twig,
/area/rogue/indoors)
"wG" = (
/turf/open/floor/rogue/dirt,
/area/rogue/outdoors/woods/south)
"wT" = (
/turf/closed/mineral/random/rogue/med,
/area/rogue/under/cavewet/bogcaves/north)
"xe" = (
/turf/closed/wall/mineral/rogue/wooddark/vertical,
/area/rogue/indoors)
"xH" = (
/obj/structure/flora/newtree,
/turf/open/floor/rogue/grass,
/area/rogue/outdoors/woods/south)
"ya" = (
/obj/structure/wallladder,
/turf/open/floor/rogue/grass,
/area/rogue/outdoors/woods/south)
"yq" = (
/obj/structure/flora/roguegrass,
/obj/structure/fluff/railing/border/west{
	dir = 6
	},
/turf/open/floor/rogue/grass,
/area/rogue/outdoors/woods/south)
"yw" = (
/obj/structure/closet/crate/chest/crate,
/obj/effect/spawner/lootdrop/roguetown/dungeon/weapons,
/turf/open/floor/rogue/naturalstone,
/area/rogue/under/cavewet/bogcaves/north)
"yz" = (
/obj/structure/flora/roguegrass,
/obj/structure/fluff/railing/border/west{
	dir = 4
	},
/turf/open/floor/rogue/dirt,
/area/rogue/outdoors/woods/south)
"zM" = (
/obj/structure/table/wood/map/two,
/obj/effect/decal/cleanable/dirt/cobweb,
/obj/effect/decal/cleanable/debris/woody,
/obj/effect/decal/cleanable/debris/stony,
/turf/open/floor/rogue/blocks/stonered,
/area/rogue/indoors)
"Ak" = (
/obj/item/cigbutt/roach{
	pixel_y = 1;
	pixel_x = -6
	},
/obj/item/ash,
/turf/open/floor/rogue/blocks/stonered/tiny,
/area/rogue/indoors)
"AF" = (
/obj/structure/mineral_door/wood/deadbolt{
	dir = 1;
	locked = 1;
	name = "rotting door";
	color = "#778079";
	max_integrity = 500
	},
/turf/open/floor/rogue/blocks/stonered,
/area/rogue/indoors)
"BC" = (
/obj/effect/decal/remains/human,
/turf/open/floor/rogue/blocks/stonered/tiny,
/area/rogue/indoors)
"BX" = (
/obj/effect/decal/cleanable/blood/footprints/mud,
/turf/open/floor/rogue/blocks/stonered,
/area/rogue/indoors)
"CC" = (
/turf/closed/wall/mineral/rogue/wooddark/end/north,
/area/rogue/indoors)
"Dc" = (
/obj/structure/flora/roguegrass/bush/wall/tall,
/turf/open/floor/rogue/grass,
/area/rogue/outdoors/woods/south)
"Dr" = (
/obj/effect/decal/cleanable/dirt/cobweb{
	dir = 8
	},
/turf/open/transparent/openspace,
/area/rogue/indoors)
"Fq" = (
/mob/living/carbon/human/species/skeleton/npc/mediumspread,
/obj/structure/chair/stool/rogue,
/obj/effect/decal/cleanable/blood/footprints/mud,
/turf/open/floor/rogue/blocks/stonered,
/area/rogue/indoors)
"FL" = (
/obj/structure/mineral_door/wood/deadbolt{
	dir = 4;
	locked = 1;
	name = "rotting door";
	color = "#778079";
	max_integrity = 500
	},
/turf/open/floor/rogue/blocks/stonered,
/area/rogue/indoors)
"FQ" = (
/obj/item/ash{
	pixel_x = -16;
	pixel_y = -4
	},
/obj/item/cigbutt/roach{
	pixel_x = -21
	},
/turf/open/floor/rogue/blocks/stonered,
/area/rogue/indoors)
"FV" = (
/obj/structure/mineral_door/wood/deadbolt{
	dir = 4;
	locked = 1;
	name = "rotting door";
	color = "#778079";
	max_integrity = 500
	},
/turf/open/floor/rogue/blocks/stonered/tiny,
/area/rogue/indoors)
"Gl" = (
/obj/effect/decal/cleanable/dirt/cobweb{
	dir = 4
	},
/obj/structure/closet/crate/chest/neu,
/turf/open/floor/rogue/blocks/stonered/tiny,
/area/rogue/indoors)
"GM" = (
/obj/structure/flora/roguegrass/bush/westleach,
/obj/structure/fluff/railing/border/west{
	dir = 4
	},
/obj/structure/fluff/railing/border,
/obj/structure/fluff/railing/border/west{
	dir = 6
	},
/turf/open/floor/rogue/grass,
/area/rogue/outdoors/woods/south)
"GO" = (
/obj/machinery/light/rogue/candle/l,
/turf/open/floor/rogue/blocks/stonered/tiny,
/area/rogue/indoors)
"Hr" = (
/obj/structure/closet/crate/chest/neu_iron,
/turf/open/floor/rogue/blocks/stonered/tiny,
/area/rogue/indoors)
"Im" = (
/obj/structure/fluff/railing/wood/north{
	pixel_y = 1
	},
/obj/structure/fluff/railing/wood/west,
/turf/open/floor/rogue/twig,
/area/rogue/indoors)
"IF" = (
/obj/structure/stairs{
	dir = 1
	},
/turf/open/floor/rogue/blocks/stonered,
/area/rogue/indoors)
"Jf" = (
/mob/living/simple_animal/hostile/rogue/deepone,
/turf/open/floor/rogue/naturalstone,
/area/rogue/under/cavewet/bogcaves/north)
"Js" = (
/turf/open/floor/rogue/blocks/stonered,
/area/rogue/indoors)
"JD" = (
/obj/effect/decal/cleanable/blood/footprints/mud,
/turf/open/floor/rogue/dirt/road,
/area/rogue/outdoors/woods/south)
"Kr" = (
/obj/item/reagent_containers/food/snacks/crow{
	dir = 4
	},
/turf/open/floor/rogue/rooftop/green/north,
/area/rogue/outdoors/town/roofs)
"Ku" = (
/obj/structure/fluff/railing/wood/north{
	pixel_y = 1
	},
/obj/structure/fluff/railing/wood/east,
/turf/open/floor/rogue/twig,
/area/rogue/indoors)
"KK" = (
/obj/structure/fluff/railing/wood/east,
/turf/open/floor/rogue/twig,
/area/rogue/indoors)
"MW" = (
/turf/open/floor/rogue/rooftop/green/north,
/area/rogue/outdoors/town/roofs)
"NA" = (
/obj/effect/decal/cleanable/dirt/cobweb{
	dir = 4
	},
/turf/open/floor/rogue/blocks/stonered/tiny,
/area/rogue/indoors)
"NJ" = (
/obj/effect/decal/cleanable/dirt/cobweb{
	dir = 1
	},
/obj/effect/decal/remains/human,
/turf/open/floor/rogue/blocks/stonered/tiny,
/area/rogue/indoors)
"NM" = (
/obj/structure/fluff/railing/border/west{
	dir = 2
	},
/turf/open/floor/rogue/grass,
/area/rogue/outdoors/woods/south)
"NN" = (
/obj/structure/fluff/railing/border/west{
	layer = 4.3
	},
/turf/open/floor/rogue/grass,
/area/rogue/outdoors/woods/south)
"NO" = (
/obj/structure/flora/roguegrass,
/turf/open/floor/rogue/grass,
/area/rogue/outdoors/woods/south)
"OT" = (
/obj/structure/toilet,
/obj/item/natural/cloth{
	pixel_x = -8
	},
/obj/effect/decal/cleanable/dirt/cobweb{
	dir = 1
	},
/turf/open/floor/rogue/blocks/stonered/tiny,
/area/rogue/indoors)
"Pa" = (
/obj/effect/decal/cleanable/dirt/cobweb/cobweb2,
/turf/open/floor/rogue/blocks/stonered/tiny,
/area/rogue/indoors)
"PO" = (
/turf/closed/wall/mineral/rogue/wooddark,
/area/rogue/indoors)
"Re" = (
/turf/closed/wall/mineral/rogue/wooddark/window,
/area/rogue/indoors)
"Sz" = (
/turf/closed/mineral/random/rogue,
/area/rogue/under/cavewet/bogcaves/north)
"SA" = (
/obj/structure/fluff/railing/wood/west,
/turf/open/floor/rogue/twig,
/area/rogue/indoors)
"SB" = (
/obj/structure/fluff/railing/border/west{
	layer = 4.3
	},
/turf/open/floor/rogue/dirt,
/area/rogue/outdoors/woods/south)
"Tu" = (
/obj/structure/fluff/railing/border/west{
	dir = 6
	},
/turf/open/floor/rogue/grass,
/area/rogue/outdoors/woods/south)
"Vy" = (
/obj/effect/decal/cleanable/dirt/cobweb{
	dir = 1
	},
/turf/open/floor/rogue/blocks/stonered/tiny,
/area/rogue/indoors)
"WW" = (
/obj/effect/decal/remains/human,
/turf/open/floor/rogue/blocks/stonered,
/area/rogue/indoors)
"Yx" = (
/turf/closed/wall/mineral/rogue/wooddark/end/west,
/area/rogue/indoors)
"YK" = (
/obj/structure/mineral_door/wood/deadbolt{
	dir = 1;
	locked = 1;
	name = "rotting door";
	color = "#778079";
	max_integrity = 500
	},
/obj/effect/decal/cleanable/blood/footprints/mud,
/turf/open/floor/rogue/blocks/stonered,
/area/rogue/indoors)
"Zr" = (
/obj/structure/table/wood/map/five,
/obj/effect/decal/cleanable/dirt/cobweb{
	dir = 4
	},
/obj/machinery/light/rogue/candle,
/turf/open/floor/rogue/blocks/stonered/tiny,
/area/rogue/indoors)
"ZB" = (
/turf/open/floor/rogue/blocks/stonered/tiny,
/area/rogue/indoors)
"ZN" = (
/obj/structure/fluff/railing/border,
/obj/structure/fluff/railing/border/west,
/obj/structure/fluff/railing/border/west{
	dir = 10
	},
/turf/open/floor/rogue/grass,
/area/rogue/outdoors/woods/south)

(1,1,1) = {"
gr
dk
dk
dk
dk
dk
dk
dk
dk
dk
dk
dk
dk
"}
(2,1,1) = {"
dk
dk
dk
dk
dk
dk
dk
dk
dk
dk
dk
dk
dk
"}
(3,1,1) = {"
dk
dk
dk
dk
dk
dk
dk
dk
dk
dk
dk
dk
dk
"}
(4,1,1) = {"
dk
dk
dk
dk
dk
dk
dk
dk
dk
dk
dk
dk
dk
"}
(5,1,1) = {"
dk
dk
dk
dk
dk
dk
dk
dk
dk
dk
dk
dk
dk
"}
(6,1,1) = {"
dk
dk
dk
dk
dk
dk
dk
dk
dk
dk
dk
dk
dk
"}
(7,1,1) = {"
dk
dk
dk
dk
dk
dk
dk
dk
dk
dk
dk
dk
dk
"}
(8,1,1) = {"
dk
dk
dk
dk
dk
dk
dk
dk
dk
dk
dk
dk
dk
"}
(9,1,1) = {"
dk
dk
dk
dk
dk
dk
dk
dk
dk
dk
dk
dk
dk
"}
(10,1,1) = {"
dk
dk
dk
dk
dk
dk
dk
dk
dk
dk
dk
dk
dk
"}
(11,1,1) = {"
dk
dk
dk
dk
dk
dk
dk
dk
dk
dk
dk
dk
dk
"}
(12,1,1) = {"
Sz
wT
wT
wT
wT
wT
wT
Sz
Sz
Sz
Sz
Sz
Sz
"}
(13,1,1) = {"
Sz
wT
wT
wT
wT
wT
wT
wT
wT
wT
Sz
Sz
Sz
"}
(14,1,1) = {"
Sz
Sz
Sz
Sz
Sz
Sz
Sz
wT
wT
wT
Sz
Sz
Sz
"}
(15,1,1) = {"
gr
Sz
Jf
yw
Sz
Sz
Sz
wT
wT
wT
wT
wT
Sz
"}

(1,1,2) = {"
su
xH
su
xH
su
su
su
su
xH
su
nU
su
xH
"}
(2,1,2) = {"
xH
su
su
NO
PO
vl
vl
PO
Re
Re
vl
PO
su
"}
(3,1,2) = {"
su
su
su
fW
vl
GO
ZB
iU
ZB
BC
NA
vl
NO
"}
(4,1,2) = {"
xH
su
xH
wG
vl
OT
em
gp
iV
rw
ZB
Re
hB
"}
(5,1,2) = {"
su
yq
ro
yz
PO
vl
vl
vl
vl
CC
jY
PO
hB
"}
(6,1,2) = {"
Tu
GM
Re
Re
gp
ZB
ZB
GO
ZB
ZB
ZB
gp
hB
"}
(7,1,2) = {"
NM
Re
qQ
fg
ZB
gN
Js
Js
Js
Js
ZB
AF
hB
"}
(8,1,2) = {"
NM
PO
Zr
zM
Fq
BX
Js
WW
Js
Js
ZB
PO
hB
"}
(9,1,2) = {"
NM
Re
fV
pt
gN
ZB
Js
Js
BX
BX
gb
YK
JD
"}
(10,1,2) = {"
mF
ZN
Re
Re
Yx
Pa
ZB
tH
fL
Vy
bw
Yx
hB
"}
(11,1,2) = {"
xH
mF
SB
NN
PO
vl
vl
vl
vl
CC
FL
PO
wG
"}
(12,1,2) = {"
su
NO
NO
Dc
vl
vl
vl
vl
wk
ZB
ZB
Re
Dc
"}
(13,1,2) = {"
xH
fW
NO
ya
vl
CC
xe
IF
ZB
ZB
ne
vl
xH
"}
(14,1,2) = {"
xH
xH
su
su
PO
vl
vl
vl
Re
Re
vl
PO
su
"}
(15,1,2) = {"
su
su
su
xH
su
su
nU
NO
su
NO
su
su
NO
"}

(1,1,3) = {"
eJ
eJ
eJ
eJ
eJ
eJ
eJ
eJ
eJ
eJ
eJ
eJ
eJ
"}
(2,1,3) = {"
eJ
eJ
eJ
eJ
PO
vl
Re
vl
Re
vl
vl
PO
eJ
"}
(3,1,3) = {"
eJ
eJ
eJ
eJ
vl
rx
ZB
kk
ZB
ea
lH
vl
eJ
"}
(4,1,3) = {"
eJ
eJ
eJ
eJ
vl
Gl
ZB
cI
ZB
Gl
BC
vl
eJ
"}
(5,1,3) = {"
eJ
eJ
eJ
eJ
PO
kj
ZB
ZB
ZB
ZB
ZB
vl
eJ
"}
(6,1,3) = {"
eJ
eJ
PO
SA
vl
ea
ZB
ea
ZB
kk
ZB
vl
eJ
"}
(7,1,3) = {"
eJ
Im
wu
Js
Yx
Hr
ZB
Hr
BC
Hr
ZB
Re
eJ
"}
(8,1,3) = {"
eJ
nt
FQ
Js
AF
ZB
ZB
ZB
ZB
ZB
ZB
vl
eJ
"}
(9,1,3) = {"
eJ
Ku
mA
Js
gp
ZB
ZB
ZB
pr
ZB
fL
Re
eJ
"}
(10,1,3) = {"
eJ
eJ
PO
KK
vl
ZB
ZB
iN
CC
FV
vP
vl
eJ
"}
(11,1,3) = {"
eJ
eJ
eJ
eJ
PO
fi
vP
vl
vl
Ak
kA
vl
eJ
"}
(12,1,3) = {"
eJ
eJ
eJ
eJ
vl
ZB
ZB
ZB
vl
ZB
gn
vl
eJ
"}
(13,1,3) = {"
eJ
eJ
eJ
ow
vl
ZB
pb
Dr
vl
NJ
gn
vl
eJ
"}
(14,1,3) = {"
eJ
eJ
eJ
eJ
PO
vl
vl
vl
Re
Re
vl
PO
eJ
"}
(15,1,3) = {"
eJ
eJ
eJ
eJ
eJ
eJ
eJ
eJ
eJ
eJ
eJ
eJ
eJ
"}

(1,1,4) = {"
eJ
eJ
eJ
eJ
eJ
eJ
eJ
eJ
eJ
eJ
eJ
eJ
eJ
"}
(2,1,4) = {"
eJ
eJ
eJ
eJ
MW
MW
MW
MW
MW
MW
MW
MW
eJ
"}
(3,1,4) = {"
eJ
eJ
eJ
eJ
MW
MW
MW
MW
MW
MW
MW
MW
eJ
"}
(4,1,4) = {"
eJ
eJ
eJ
eJ
MW
MW
MW
kn
MW
MW
MW
MW
eJ
"}
(5,1,4) = {"
eJ
eJ
eJ
eJ
MW
MW
MW
MW
Kr
MW
MW
MW
eJ
"}
(6,1,4) = {"
eJ
eJ
MW
MW
MW
kn
kn
MW
fN
Kr
MW
MW
eJ
"}
(7,1,4) = {"
eJ
MW
MW
MW
MW
MW
fN
MW
MW
kn
MW
MW
eJ
"}
(8,1,4) = {"
eJ
MW
MW
MW
MW
MW
MW
MW
MW
qN
fN
MW
eJ
"}
(9,1,4) = {"
eJ
MW
MW
MW
kn
kn
kn
fN
MW
vB
MW
MW
eJ
"}
(10,1,4) = {"
eJ
eJ
MW
MW
MW
MW
MW
MW
MW
dU
MW
MW
eJ
"}
(11,1,4) = {"
eJ
eJ
eJ
eJ
MW
MW
MW
MW
dU
MW
MW
MW
eJ
"}
(12,1,4) = {"
eJ
eJ
eJ
eJ
MW
MW
MW
MW
MW
MW
MW
MW
eJ
"}
(13,1,4) = {"
eJ
eJ
eJ
ow
MW
MW
MW
MW
MW
MW
MW
MW
eJ
"}
(14,1,4) = {"
eJ
eJ
eJ
eJ
MW
MW
MW
MW
MW
MW
MW
kn
eJ
"}
(15,1,4) = {"
eJ
eJ
eJ
eJ
eJ
eJ
eJ
eJ
eJ
eJ
eJ
eJ
eJ
"}
