//MAP CONVERTED BY dmm2tgm.py THIS HEADER COMMENT PREVENTS RECONVERSION, DO NOT REMOVE
"a" = (
/turf/open/floor/rogue/grass,
/area/rogue)
"c" = (
/obj/item/grown/log/tree/small,
/turf/open/floor/rogue/dirt/road,
/area/rogue)
"d" = (
/obj/structure/flora/newtree,
/turf/open/floor/rogue/grass,
/area/rogue)
"e" = (
/turf/open/floor/rogue/twig,
/area/rogue)
"f" = (
/turf/closed/mineral/random/rogue/high,
/area/rogue)
"g" = (
/obj/machinery/light/rogue/campfire,
/turf/open/floor/rogue/dirt,
/area/rogue)
"h" = (
/obj/structure/mineral_door/wood/deadbolt{
	dir = 1;
	locked = 1
	},
/turf/open/floor/rogue/twig,
/area/rogue)
"i" = (
/turf/closed/wall/mineral/rogue/wooddark,
/area/rogue)
"j" = (
/turf/open/transparent/openspace,
/area/rogue)
"k" = (
/obj/item/chair/stool/bar/rogue/crafted,
/turf/open/floor/rogue/dirt/road,
/area/rogue)
"l" = (
/turf/closed/mineral/random/rogue/med,
/area/rogue)
"m" = (
/turf/closed/wall/mineral/rogue/wooddark/vertical,
/area/rogue)
"n" = (
/turf/closed/mineral/random/rogue,
/area/rogue)
"o" = (
/mob/living/carbon/human/species/skeleton/npc/mediumspread,
/turf/open/floor/rogue/ruinedwood,
/area/rogue)
"q" = (
/obj/structure/fluff/railing/wood/north{
	pixel_y = 1
	},
/turf/open/floor/rogue/twig,
/area/rogue)
"r" = (
/obj/structure/closet/crate/chest/crate,
/obj/effect/spawner/lootdrop/roguetown/dungeon/weapons,
/turf/open/floor/rogue/naturalstone,
/area/rogue)
"s" = (
/obj/structure/fluff/railing/wood/north{
	pixel_y = 1
	},
/obj/structure/fluff/railing/wood/west,
/turf/open/floor/rogue/twig,
/area/rogue)
"t" = (
/obj/item/reagent_containers/food/snacks/crow,
/turf/open/floor/rogue/rooftop/green/north,
/area/rogue)
"u" = (
/obj/item/grown/log/tree/stick,
/turf/open/floor/rogue/dirt,
/area/rogue)
"v" = (
/obj/structure/chair/stool/rogue,
/turf/open/floor/rogue/dirt,
/area/rogue)
"w" = (
/obj/structure/roguewindow,
/turf/open/floor/rogue/ruinedwood/turned,
/area/rogue)
"x" = (
/turf/closed/wall/mineral/rogue/wooddark/end/north,
/area/rogue)
"y" = (
/turf/open/floor/rogue/dirt/road,
/area/rogue)
"z" = (
/turf/open/floor/rogue/ruinedwood/turned,
/area/rogue)
"A" = (
/obj/structure/stairs{
	dir = 1
	},
/turf/open/floor/rogue/twig,
/area/rogue)
"B" = (
/mob/living/simple_animal/hostile/rogue/deepone,
/turf/open/floor/rogue/naturalstone,
/area/rogue)
"C" = (
/obj/item/reagent_containers/food/snacks/crow{
	dir = 1
	},
/turf/open/floor/rogue/rooftop/green/north,
/area/rogue)
"D" = (
/obj/structure/roguewindow,
/turf/open/floor/rogue/grass,
/area/rogue)
"E" = (
/obj/item/grown/log/tree/stick,
/turf/open/floor/rogue/twig,
/area/rogue)
"F" = (
/turf/open/floor/rogue/naturalstone,
/area/rogue)
"G" = (
/obj/structure/flora/newtree,
/turf/open/floor/rogue/dirt/road,
/area/rogue)
"H" = (
/obj/structure/closet/crate/chest/wicker,
/turf/open/floor/rogue/ruinedwood,
/area/rogue)
"I" = (
/obj/structure/fluff/railing/wood/west,
/turf/open/floor/rogue/twig,
/area/rogue)
"J" = (
/obj/structure/chair/stool/rogue,
/turf/open/floor/rogue/dirt/road,
/area/rogue)
"K" = (
/obj/item/reagent_containers/food/snacks/crow{
	dir = 4
	},
/turf/open/floor/rogue/rooftop/green/north,
/area/rogue)
"L" = (
/turf/open/floor/rogue/dirt,
/area/rogue)
"N" = (
/obj/structure/table/wood/poor,
/turf/open/floor/rogue/dirt/road,
/area/rogue)
"O" = (
/obj/structure/stairs{
	dir = 1
	},
/turf/open/floor/rogue/ruinedwood,
/area/rogue)
"Q" = (
/obj/structure/fluff/railing/wood/east,
/turf/open/floor/rogue/twig,
/area/rogue)
"R" = (
/obj/structure/roguewindow,
/turf/open/floor/rogue/twig,
/area/rogue)
"S" = (
/obj/structure/fluff/railing/wood/north{
	pixel_y = 1
	},
/obj/structure/fluff/railing/wood/east,
/turf/open/floor/rogue/twig,
/area/rogue)
"T" = (
/obj/item/reagent_containers/food/snacks/crow{
	dir = 8
	},
/turf/open/floor/rogue/rooftop/green/north,
/area/rogue)
"V" = (
/turf/closed/wall/mineral/rogue/decowood,
/area/rogue)
"W" = (
/turf/open/floor/rogue/ruinedwood,
/area/rogue)
"X" = (
/obj/structure/bed/rogue/shit,
/turf/open/floor/rogue/twig,
/area/rogue)
"Z" = (
/turf/open/floor/rogue/rooftop/green/north,
/area/rogue)

(1,1,1) = {"
F
f
f
f
f
f
f
f
f
f
f
f
f
"}
(2,1,1) = {"
f
f
f
f
f
f
f
f
f
f
f
f
f
"}
(3,1,1) = {"
f
f
f
f
f
f
f
f
f
f
f
f
f
"}
(4,1,1) = {"
f
f
f
f
f
f
f
f
f
f
f
f
f
"}
(5,1,1) = {"
f
f
f
f
f
f
f
f
f
f
f
f
f
"}
(6,1,1) = {"
f
f
f
f
f
f
f
f
f
f
f
f
f
"}
(7,1,1) = {"
f
f
f
f
f
f
f
f
f
f
f
f
f
"}
(8,1,1) = {"
f
f
f
f
f
f
f
f
f
f
f
f
f
"}
(9,1,1) = {"
f
f
f
f
f
f
f
f
f
f
f
f
f
"}
(10,1,1) = {"
f
f
f
f
f
f
f
f
f
f
f
f
f
"}
(11,1,1) = {"
f
f
f
f
f
f
f
f
f
f
f
f
f
"}
(12,1,1) = {"
n
l
l
l
l
l
l
n
n
n
n
n
n
"}
(13,1,1) = {"
n
l
l
l
l
l
l
l
l
l
n
n
n
"}
(14,1,1) = {"
n
n
n
n
n
n
n
l
l
l
n
n
n
"}
(15,1,1) = {"
F
n
B
r
n
n
n
l
l
l
l
l
n
"}

(1,1,2) = {"
a
a
a
d
a
a
a
a
a
a
a
a
a
"}
(2,1,2) = {"
a
a
a
a
i
V
L
V
R
E
V
i
a
"}
(3,1,2) = {"
a
a
a
a
V
v
L
L
L
y
y
V
a
"}
(4,1,2) = {"
a
a
a
L
V
g
L
u
G
y
c
R
y
"}
(5,1,2) = {"
a
a
a
L
V
v
L
L
y
y
y
E
y
"}
(6,1,2) = {"
a
a
i
I
W
L
L
y
y
y
y
V
y
"}
(7,1,2) = {"
a
e
q
e
W
u
J
N
N
y
W
h
y
"}
(8,1,2) = {"
a
i
e
e
W
W
y
N
N
J
W
V
y
"}
(9,1,2) = {"
a
e
q
e
W
W
y
N
N
W
W
h
y
"}
(10,1,2) = {"
a
a
i
Q
W
W
y
k
y
W
W
V
y
"}
(11,1,2) = {"
a
a
L
a
V
W
W
y
W
o
W
R
L
"}
(12,1,2) = {"
a
a
a
a
V
W
W
W
W
W
W
R
a
"}
(13,1,2) = {"
d
a
a
a
V
x
m
O
W
W
H
V
a
"}
(14,1,2) = {"
d
a
a
a
i
V
V
V
D
R
V
i
a
"}
(15,1,2) = {"
a
a
a
a
a
a
a
a
a
a
a
a
a
"}

(1,1,3) = {"
j
j
j
j
j
j
j
j
j
j
j
j
j
"}
(2,1,3) = {"
j
j
j
j
i
V
V
V
w
w
V
i
j
"}
(3,1,3) = {"
j
j
j
j
V
X
e
e
j
e
e
V
j
"}
(4,1,3) = {"
j
j
j
j
V
e
e
j
j
j
e
V
j
"}
(5,1,3) = {"
j
j
j
j
i
e
e
j
j
j
e
w
j
"}
(6,1,3) = {"
j
j
i
I
z
e
j
j
j
j
e
w
j
"}
(7,1,3) = {"
j
s
e
e
z
e
j
j
j
j
e
V
j
"}
(8,1,3) = {"
j
q
e
e
z
e
j
j
j
j
e
V
j
"}
(9,1,3) = {"
j
S
e
e
z
e
e
j
j
j
e
V
j
"}
(10,1,3) = {"
j
j
i
Q
z
e
j
j
j
j
e
w
j
"}
(11,1,3) = {"
j
j
j
j
i
e
e
j
j
j
e
w
j
"}
(12,1,3) = {"
j
j
j
j
V
e
e
e
e
e
e
V
j
"}
(13,1,3) = {"
j
j
j
j
V
e
A
j
j
e
X
V
j
"}
(14,1,3) = {"
j
j
j
j
i
V
V
V
w
w
V
i
j
"}
(15,1,3) = {"
j
j
j
j
j
j
j
j
j
j
j
j
j
"}

(1,1,4) = {"
j
j
j
j
j
j
j
j
j
j
j
j
j
"}
(2,1,4) = {"
j
j
j
j
Z
Z
Z
Z
Z
Z
Z
Z
j
"}
(3,1,4) = {"
j
j
j
j
Z
Z
Z
Z
Z
Z
Z
Z
j
"}
(4,1,4) = {"
j
j
j
j
Z
Z
Z
Z
Z
Z
Z
Z
j
"}
(5,1,4) = {"
j
j
j
j
Z
Z
K
K
Z
K
Z
Z
j
"}
(6,1,4) = {"
j
j
Z
Z
Z
t
Z
Z
Z
Z
Z
Z
j
"}
(7,1,4) = {"
j
Z
Z
Z
Z
Z
Z
Z
K
Z
C
Z
j
"}
(8,1,4) = {"
j
Z
Z
Z
Z
t
Z
Z
T
Z
C
Z
j
"}
(9,1,4) = {"
j
Z
Z
Z
Z
Z
Z
Z
Z
Z
Z
Z
j
"}
(10,1,4) = {"
j
j
Z
Z
Z
t
Z
Z
T
T
Z
Z
j
"}
(11,1,4) = {"
j
j
j
j
Z
Z
Z
Z
Z
Z
Z
Z
j
"}
(12,1,4) = {"
j
j
j
j
Z
Z
Z
Z
Z
Z
Z
Z
j
"}
(13,1,4) = {"
j
j
j
j
Z
Z
Z
Z
Z
Z
Z
Z
j
"}
(14,1,4) = {"
j
j
j
j
Z
Z
Z
Z
Z
Z
Z
Z
j
"}
(15,1,4) = {"
j
j
j
j
j
j
j
j
j
j
j
j
j
"}
