//MAP CONVERTED BY dmm2tgm.py THIS HEADER COMMENT PREVENTS RECONVERSION, DO NOT REMOVE
"aQ" = (
/obj/structure/table/wood/fancy/blue,
/obj/item/clothing/ring/aalloy,
/turf/open/floor/rogue/herringbone,
/area/rogue/indoors/cave)
"da" = (
/obj/structure/closet/crate/chest/crate,
/obj/effect/decal/cleanable/debris/woody,
/obj/effect/decal/cleanable/debris/stony,
/obj/item/reagent_containers/powder/moondust,
/turf/open/floor/carpet/stellar,
/area/rogue/indoors/cave)
"dl" = (
/obj/item/reagent_containers/powder/salt,
/turf/open/floor/carpet/royalblack,
/area/rogue/indoors/cave)
"dO" = (
/obj/structure/table/wood/poor,
/obj/item/natural/clay/claystatue,
/turf/open/floor/rogue/ruinedwood/turned,
/area/rogue/indoors/town)
"eP" = (
/turf/closed/wall/mineral/rogue/craftstone,
/area/rogue/indoors/town)
"fH" = (
/obj/machinery/light/rogue/campfire/fireplace{
	pixel_y = 32
	},
/turf/open/floor/rogue/ruinedwood/turned,
/area/rogue/indoors/town)
"fX" = (
/obj/structure/flora/roguegrass,
/turf/open/floor/rogue/grass,
/area/rogue/outdoors/woods/north)
"hB" = (
/obj/structure/mineral_door/wood/deadbolt{
	dir = 4
	},
/turf/open/floor/rogue/ruinedwood/turned,
/area/rogue/indoors/town)
"is" = (
/obj/structure/ladder,
/obj/effect/decal/cleanable/blood/footprints/mud,
/turf/open/floor/carpet/royalblack,
/area/rogue/indoors/cave)
"lN" = (
/obj/effect/decal/cleanable/debris/woody,
/turf/closed/wall/mineral/rogue/craftstone{
	density = 0
	},
/area/rogue/indoors/cave)
"mb" = (
/obj/structure/closet/crate/chest/crate,
/obj/item/reagent_containers/powder/ozium,
/turf/open/floor/carpet/stellar,
/area/rogue/indoors/cave)
"mj" = (
/obj/effect/decal/cleanable/dirt/cobweb{
	dir = 8
	},
/turf/open/floor/rogue/herringbone,
/area/rogue/indoors/cave)
"ms" = (
/obj/structure/closet/crate/chest/crate,
/obj/item/reagent_containers/powder/flour,
/obj/item/reagent_containers/powder/salt,
/turf/open/floor/carpet/royalblack,
/area/rogue/indoors/cave)
"no" = (
/obj/effect/decal/cleanable/debris/stony,
/obj/effect/decal/cleanable/dirt/cobweb{
	dir = 4
	},
/turf/open/floor/carpet/royalblack,
/area/rogue/indoors/cave)
"nw" = (
/obj/structure/chair/wood/rogue{
	dir = 1
	},
/turf/open/floor/rogue/ruinedwood/turned,
/area/rogue/indoors/town)
"nz" = (
/obj/structure/flora/roguegrass,
/turf/open/floor/rogue/dirt,
/area/rogue/outdoors/woods/north)
"nP" = (
/obj/effect/decal/cleanable/dirt/cobweb,
/turf/open/floor/rogue/herringbone,
/area/rogue/indoors/cave)
"or" = (
/obj/structure/closet/crate/chest/crate,
/obj/effect/decal/cleanable/debris/stony,
/obj/effect/decal/cleanable/debris/woody,
/obj/item/reagent_containers/powder/moondust_purest,
/turf/open/floor/carpet/stellar,
/area/rogue/indoors/cave)
"oz" = (
/obj/structure/table/wood/fancy/blue,
/obj/item/candle/candlestick/gold/lit{
	pixel_y = 9
	},
/turf/open/floor/rogue/herringbone,
/area/rogue/indoors/cave)
"oZ" = (
/turf/open/floor/rogue/rooftop/green/north,
/area/rogue/outdoors/mountains)
"pv" = (
/obj/structure/trap/wall_projectile{
	dir = 1
	},
/turf/open/floor/carpet/royalblack,
/area/rogue/indoors/town)
"ru" = (
/obj/structure/closet/crate/chest/crate,
/obj/structure/closet/crate/chest/crate,
/obj/item/reagent_containers/powder/ozium,
/turf/open/floor/carpet/stellar,
/area/rogue/indoors/cave)
"sx" = (
/obj/effect/decal/cleanable/blood/footprints/mud{
	dir = 4
	},
/turf/open/floor/carpet/royalblack,
/area/rogue/indoors/cave)
"sY" = (
/obj/machinery/light/rogue/candle/weak/l,
/turf/open/floor/rogue/herringbone,
/area/rogue/indoors/cave)
"te" = (
/obj/structure/chair/wood/rogue/chair5{
	dir = 1
	},
/turf/open/floor/rogue/herringbone,
/area/rogue/indoors/cave)
"tI" = (
/obj/item/reagent_containers/powder/ozium,
/obj/structure/table/wood/fancy/black,
/turf/open/floor/rogue/herringbone,
/area/rogue/indoors/cave)
"wc" = (
/obj/effect/decal/cleanable/blood/footprints/mud{
	dir = 4
	},
/turf/closed/wall/mineral/rogue/craftstone{
	density = 0
	},
/area/rogue/indoors/cave)
"wL" = (
/obj/effect/decal/cleanable/debris/stony,
/turf/open/floor/carpet/royalblack,
/area/rogue/indoors/cave)
"wV" = (
/obj/structure/roguemachine/drugmachine{
	density = 0;
	pixel_y = 32
	},
/obj/structure/chair/wood/rogue/chair5,
/turf/open/floor/rogue/herringbone,
/area/rogue/indoors/cave)
"yu" = (
/obj/effect/decal/cleanable/blood/footprints/mud,
/turf/open/floor/carpet/royalblack,
/area/rogue/indoors/town)
"zp" = (
/obj/structure/ladder,
/obj/effect/decal/cleanable/blood/footprints/mud,
/turf/open/floor/carpet/royalblack,
/area/rogue/indoors/town)
"Bf" = (
/obj/effect/landmark/chest_or_mimic/loot_chest,
/turf/open/floor/carpet/stellar,
/area/rogue/indoors/cave)
"Cr" = (
/turf/closed/wall/mineral/rogue/decowood,
/area/rogue/indoors/town)
"Db" = (
/obj/machinery/light/rogue/hearth,
/obj/item/cooking/pan,
/turf/open/floor/rogue/ruinedwood/turned,
/area/rogue/indoors/town)
"Df" = (
/mob/living/carbon/human/species/human/northern/thief,
/obj/structure/chair/wood/rogue/chair5,
/obj/effect/decal/cleanable/debris/stony,
/turf/open/floor/rogue/herringbone,
/area/rogue/indoors/cave)
"Dq" = (
/obj/item/reagent_containers/powder/herozium,
/obj/structure/table/wood/fancy/black,
/obj/effect/decal/cleanable/debris/stony,
/turf/open/floor/rogue/herringbone,
/area/rogue/indoors/cave)
"DX" = (
/turf/open/floor/rogue/grass,
/area/rogue/outdoors/woods/north)
"El" = (
/turf/open/floor/rogue/rooftop/green/north,
/area/rogue/outdoors/beach/forest/south)
"Em" = (
/obj/structure/trap/shock,
/turf/open/floor/carpet/royalblack,
/area/rogue/indoors/town)
"EM" = (
/turf/closed/mineral/random/rogue,
/area/rogue/indoors/cave)
"EW" = (
/turf/closed/wall/mineral/rogue/craftstone,
/area/rogue/indoors/cave)
"Ic" = (
/turf/closed/wall/mineral/rogue/stone,
/area/rogue/indoors/town)
"Kb" = (
/turf/open/floor/rogue/ruinedwood/turned,
/area/rogue/indoors/town)
"Ky" = (
/obj/structure/table/wood/poor,
/obj/item/natural/clay/clayfancyvase{
	pixel_y = 9;
	pixel_x = -7
	},
/turf/open/floor/rogue/ruinedwood/turned,
/area/rogue/indoors/town)
"KW" = (
/obj/effect/decal/cleanable/blood/footprints/mud,
/obj/item/reagent_containers/powder/salt,
/turf/open/floor/carpet/royalblack,
/area/rogue/indoors/cave)
"Ll" = (
/turf/open/floor/rogue/dirt,
/area/rogue/outdoors/woods/north)
"Mu" = (
/obj/effect/decal/cleanable/debris/stony,
/obj/effect/decal/cleanable/dirt/cobweb,
/turf/open/floor/carpet/royalblack,
/area/rogue/indoors/cave)
"MR" = (
/obj/structure/flora/roguegrass,
/obj/structure/flora/roguegrass/herb/random,
/turf/open/floor/rogue/grass,
/area/rogue/outdoors/woods/north)
"MW" = (
/obj/structure/flora/roguegrass,
/obj/structure/flora/newtree,
/turf/open/floor/rogue/grass,
/area/rogue/outdoors/woods/north)
"Nb" = (
/obj/effect/decal/cleanable/debris/stony,
/turf/open/floor/rogue/herringbone,
/area/rogue/indoors/cave)
"NY" = (
/obj/structure/closet/crate/chest/crate,
/obj/item/clothing/suit/roguetown/shirt/tunic/black,
/obj/item/clothing/under/roguetown/trou,
/obj/effect/spawner/lootdrop/roguetown/dungeon/misc,
/obj/item/clothing/head/roguetown/fisherhat,
/turf/open/floor/rogue/ruinedwood/turned,
/area/rogue/indoors/town)
"OI" = (
/obj/structure/flora/roguegrass/herb/random,
/turf/open/floor/rogue/grass,
/area/rogue/outdoors/woods/north)
"PG" = (
/mob/living/carbon/human/species/human/northern/thief,
/turf/open/floor/rogue/herringbone,
/area/rogue/indoors/cave)
"PN" = (
/turf/open/transparent/openspace,
/area/rogue/outdoors/mountains)
"Qn" = (
/obj/structure/roguewindow,
/turf/open/floor/rogue/ruinedwood/turned,
/area/rogue/indoors/town)
"RE" = (
/mob/living/carbon/human/species/human/northern/thief,
/obj/machinery/light/rogue/candle/weak/l,
/turf/open/floor/rogue/herringbone,
/area/rogue/indoors/cave)
"RG" = (
/obj/effect/decal/cleanable/debris/stony,
/obj/effect/decal/cleanable/debris/woody,
/turf/open/floor/rogue/herringbone,
/area/rogue/indoors/cave)
"RZ" = (
/mob/living/carbon/human/species/human/northern/thief,
/obj/structure/chair/wood/rogue/chair5,
/turf/open/floor/carpet/royalblack,
/area/rogue/indoors/cave)
"Sc" = (
/turf/open/floor/carpet/stellar,
/area/rogue/indoors/cave)
"Sx" = (
/obj/structure/flora/newtree,
/turf/open/floor/rogue/grass,
/area/rogue/outdoors/woods/north)
"Uz" = (
/turf/closed/wall/mineral/rogue/craftstone{
	density = 0
	},
/area/rogue/indoors/town)
"Vv" = (
/turf/closed/wall/mineral/rogue/wooddark/slitted,
/area/rogue/indoors/town)
"Vz" = (
/mob/living/carbon/human/species/human/northern/thief,
/obj/structure/chair/wood/rogue/chair5{
	dir = 1
	},
/turf/open/floor/rogue/herringbone,
/area/rogue/indoors/cave)
"WW" = (
/obj/structure/closet/crate/chest/crate,
/obj/effect/decal/cleanable/debris/stony,
/obj/effect/decal/cleanable/debris/woody,
/obj/item/reagent_containers/powder/herozium,
/turf/open/floor/carpet/stellar,
/area/rogue/indoors/cave)
"Xz" = (
/obj/structure/chair/wood/rogue{
	dir = 8
	},
/turf/open/floor/rogue/ruinedwood/turned,
/area/rogue/indoors/town)
"XM" = (
/obj/structure/mineral_door/wood/deadbolt{
	dir = 1
	},
/turf/open/floor/rogue/ruinedwood/turned,
/area/rogue/indoors/town)
"XW" = (
/turf/open/transparent/openspace,
/area/rogue/outdoors/beach/forest/south)
"YG" = (
/obj/structure/bed/rogue/inn,
/obj/item/bedsheet/rogue/wool,
/mob/living/carbon/human/species/human/northern/thief,
/turf/open/floor/carpet/royalblack,
/area/rogue/indoors/town)
"Zo" = (
/turf/open/floor/carpet/royalblack,
/area/rogue/indoors/cave)
"Zu" = (
/obj/structure/rack/rogue,
/obj/item/clothing/gloves/roguetown/leather,
/turf/open/floor/rogue/ruinedwood/turned,
/area/rogue/indoors/town)
"Zy" = (
/obj/structure/table/wood/fancy/blue,
/turf/open/floor/rogue/herringbone,
/area/rogue/indoors/cave)

(1,1,1) = {"
EM
WW
mb
Bf
WW
EM
"}
(2,1,1) = {"
EM
or
Sc
da
ru
EM
"}
(3,1,1) = {"
EW
EW
EW
lN
EW
EW
"}
(4,1,1) = {"
EW
nP
RE
RG
sY
EW
"}
(5,1,1) = {"
EW
Df
tI
aQ
te
EW
"}
(6,1,1) = {"
EW
wV
oz
Dq
Vz
EW
"}
(7,1,1) = {"
EW
RZ
Dq
Zy
te
EW
"}
(8,1,1) = {"
EW
wL
Zo
PG
Nb
EW
"}
(9,1,1) = {"
EW
sx
wL
Zo
mj
EW
"}
(10,1,1) = {"
EW
wc
EW
EW
EW
EW
"}
(11,1,1) = {"
EW
Mu
KW
is
no
EW
"}
(12,1,1) = {"
EW
ms
Zo
wL
dl
EW
"}
(13,1,1) = {"
EW
EW
EW
EW
EW
EW
"}

(1,1,2) = {"
Vv
Cr
Cr
Cr
Cr
Vv
"}
(2,1,2) = {"
Cr
Ky
nw
Kb
Zu
Qn
"}
(3,1,2) = {"
Cr
Xz
Kb
Kb
Kb
Cr
"}
(4,1,2) = {"
Cr
Kb
Kb
Kb
pv
XM
"}
(5,1,2) = {"
Cr
NY
Kb
Kb
Db
Qn
"}
(6,1,2) = {"
Vv
Ic
hB
Ic
eP
Vv
"}
(7,1,2) = {"
Cr
dO
Kb
Kb
Ic
DX
"}
(8,1,2) = {"
Ic
fH
Kb
Kb
Ic
MR
"}
(9,1,2) = {"
Cr
YG
Kb
Em
Ic
MW
"}
(10,1,2) = {"
Vv
Cr
eP
Uz
eP
eP
"}
(11,1,2) = {"
fX
Sx
eP
yu
zp
eP
"}
(12,1,2) = {"
nz
Sx
eP
eP
eP
eP
"}
(13,1,2) = {"
DX
OI
DX
Sx
DX
Ll
"}

(1,1,3) = {"
El
El
oZ
oZ
oZ
oZ
"}
(2,1,3) = {"
El
El
oZ
oZ
oZ
oZ
"}
(3,1,3) = {"
El
El
oZ
oZ
oZ
oZ
"}
(4,1,3) = {"
El
El
oZ
oZ
oZ
oZ
"}
(5,1,3) = {"
El
El
oZ
oZ
oZ
oZ
"}
(6,1,3) = {"
El
El
oZ
oZ
oZ
oZ
"}
(7,1,3) = {"
El
El
oZ
oZ
oZ
PN
"}
(8,1,3) = {"
El
El
oZ
oZ
oZ
PN
"}
(9,1,3) = {"
El
El
oZ
oZ
oZ
PN
"}
(10,1,3) = {"
El
El
oZ
oZ
oZ
PN
"}
(11,1,3) = {"
XW
XW
oZ
oZ
oZ
PN
"}
(12,1,3) = {"
XW
XW
oZ
oZ
oZ
PN
"}
(13,1,3) = {"
XW
XW
PN
PN
PN
PN
"}
