//MAP CONVERTED BY dmm2tgm.py THIS HEADER COMMENT PREVENTS RECONVERSION, DO NOT REMOVE
"au" = (
/turf/closed/wall/mineral/rogue/craftstone,
/area/rogue/indoors/town)
"av" = (
/obj/structure/closet/crate/chest/crate,
/obj/item/reagent_containers/powder/ozium,
/turf/open/floor/carpet/stellar,
/area/rogue/indoors/cave)
"bo" = (
/obj/structure/table/wood/poor,
/obj/item/natural/clay/claystatue,
/turf/open/floor/rogue/ruinedwood/turned,
/area/rogue/indoors/town)
"cJ" = (
/obj/effect/decal/cleanable/blood/footprints/mud{
	dir = 4
	},
/turf/closed/wall/mineral/rogue/craftstone{
	density = 0
	},
/area/rogue/indoors/cave)
"dH" = (
/obj/item/reagent_containers/powder/ozium,
/obj/structure/table/wood/fancy/black,
/turf/open/floor/rogue/herringbone,
/area/rogue/indoors/cave)
"dU" = (
/obj/effect/decal/cleanable/debris/stony,
/obj/effect/decal/cleanable/dirt/cobweb,
/turf/open/floor/carpet/royalblack,
/area/rogue/indoors/cave)
"eu" = (
/turf/open/transparent/openspace,
/area/rogue/outdoors/mountains)
"eA" = (
/obj/structure/flora/roguegrass,
/obj/structure/flora/roguegrass/herb/random,
/turf/open/floor/rogue/grass,
/area/rogue/outdoors/woods/north)
"fu" = (
/obj/structure/rack/rogue,
/obj/item/clothing/gloves/roguetown/leather,
/turf/open/floor/rogue/ruinedwood/turned,
/area/rogue/indoors/town)
"fC" = (
/obj/effect/decal/cleanable/debris/stony,
/obj/effect/decal/cleanable/debris/woody,
/turf/open/floor/rogue/herringbone,
/area/rogue/indoors/cave)
"gn" = (
/turf/open/floor/rogue/dirt,
/area/rogue/outdoors/woods/north)
"hi" = (
/obj/structure/closet/crate/chest/crate,
/obj/effect/decal/cleanable/debris/stony,
/obj/effect/decal/cleanable/debris/woody,
/obj/item/reagent_containers/powder/herozium,
/turf/open/floor/carpet/stellar,
/area/rogue/indoors/cave)
"hu" = (
/turf/open/floor/rogue/rooftop/green/north,
/area/rogue/outdoors/beach/forest/south)
"hH" = (
/obj/structure/closet/crate/chest/crate,
/obj/effect/decal/cleanable/debris/stony,
/obj/effect/decal/cleanable/debris/woody,
/obj/item/reagent_containers/powder/moondust_purest,
/turf/open/floor/carpet/stellar,
/area/rogue/indoors/cave)
"hX" = (
/obj/effect/decal/cleanable/blood/footprints/mud{
	dir = 4
	},
/turf/open/floor/carpet/royalblack,
/area/rogue/indoors/cave)
"iD" = (
/obj/structure/closet/crate/chest/crate,
/obj/item/clothing/suit/roguetown/shirt/tunic/black,
/obj/item/clothing/under/roguetown/trou,
/obj/effect/spawner/lootdrop/roguetown/dungeon/misc,
/obj/item/clothing/head/roguetown/fisherhat,
/turf/open/floor/rogue/ruinedwood/turned,
/area/rogue/indoors/town)
"jz" = (
/obj/structure/ladder,
/obj/effect/decal/cleanable/blood/footprints/mud,
/turf/open/floor/carpet/royalblack,
/area/rogue/indoors/town)
"jQ" = (
/obj/effect/decal/cleanable/blood/footprints/mud,
/turf/open/floor/carpet/royalblack,
/area/rogue/indoors/town)
"ky" = (
/obj/effect/decal/cleanable/blood/footprints/mud,
/obj/item/reagent_containers/powder/salt,
/turf/open/floor/carpet/royalblack,
/area/rogue/indoors/cave)
"kE" = (
/obj/structure/chair/wood/rogue{
	dir = 1
	},
/turf/open/floor/rogue/ruinedwood/turned,
/area/rogue/indoors/town)
"ld" = (
/obj/structure/roguemachine/drugmachine{
	density = 0;
	pixel_y = 32
	},
/obj/structure/chair/wood/rogue/chair5,
/turf/open/floor/rogue/herringbone,
/area/rogue/indoors/cave)
"lF" = (
/obj/structure/bed/rogue/inn,
/obj/item/bedsheet/rogue/wool,
/mob/living/carbon/human/species/human/northern/thief,
/turf/open/floor/carpet/royalblack,
/area/rogue/indoors/town)
"na" = (
/obj/item/reagent_containers/powder/herozium,
/obj/structure/table/wood/fancy/black,
/obj/effect/decal/cleanable/debris/stony,
/turf/open/floor/rogue/herringbone,
/area/rogue/indoors/cave)
"ng" = (
/obj/structure/chair/wood/rogue{
	dir = 8
	},
/turf/open/floor/rogue/ruinedwood/turned,
/area/rogue/indoors/town)
"ok" = (
/obj/structure/flora/roguegrass,
/turf/open/floor/rogue/dirt,
/area/rogue/outdoors/woods/north)
"or" = (
/obj/structure/flora/roguegrass,
/obj/structure/flora/newtree,
/turf/open/floor/rogue/grass,
/area/rogue/outdoors/woods/north)
"pF" = (
/obj/effect/decal/cleanable/dirt/cobweb{
	dir = 8
	},
/turf/open/floor/rogue/herringbone,
/area/rogue/indoors/cave)
"sg" = (
/turf/open/transparent/openspace,
/area/rogue/outdoors/beach/forest/south)
"to" = (
/mob/living/carbon/human/species/human/northern/thief,
/obj/structure/chair/wood/rogue/chair5,
/obj/effect/decal/cleanable/debris/stony,
/turf/open/floor/rogue/herringbone,
/area/rogue/indoors/cave)
"tr" = (
/obj/structure/closet/crate/chest/crate,
/obj/item/reagent_containers/powder/flour,
/obj/item/reagent_containers/powder/salt,
/turf/open/floor/carpet/royalblack,
/area/rogue/indoors/cave)
"tM" = (
/obj/structure/trap/shock,
/turf/open/floor/carpet/royalblack,
/area/rogue/indoors/town)
"uw" = (
/turf/closed/wall/mineral/rogue/craftstone{
	density = 0
	},
/area/rogue/indoors/town)
"uT" = (
/mob/living/carbon/human/species/human/northern/thief,
/obj/machinery/light/rogue/candle/weak/l,
/turf/open/floor/rogue/herringbone,
/area/rogue/indoors/cave)
"vy" = (
/turf/closed/wall/mineral/rogue/wooddark/slitted,
/area/rogue/indoors/town)
"wZ" = (
/obj/structure/table/wood/fancy/blue,
/turf/open/floor/rogue/herringbone,
/area/rogue/indoors/cave)
"yp" = (
/turf/open/floor/rogue/ruinedwood/turned,
/area/rogue/indoors/town)
"yB" = (
/obj/structure/table/wood/fancy/blue,
/obj/item/candle/candlestick/gold/lit{
	pixel_y = 9
	},
/turf/open/floor/rogue/herringbone,
/area/rogue/indoors/cave)
"yM" = (
/obj/machinery/light/rogue/campfire/fireplace{
	pixel_y = 32
	},
/turf/open/floor/rogue/ruinedwood/turned,
/area/rogue/indoors/town)
"yN" = (
/turf/open/floor/rogue/grass,
/area/rogue/outdoors/woods/north)
"zM" = (
/turf/open/floor/carpet/stellar,
/area/rogue/indoors/cave)
"zO" = (
/obj/structure/flora/roguegrass,
/turf/open/floor/rogue/grass,
/area/rogue/outdoors/woods/north)
"zR" = (
/obj/structure/ladder,
/obj/effect/decal/cleanable/blood/footprints/mud,
/turf/open/floor/carpet/royalblack,
/area/rogue/indoors/cave)
"AX" = (
/mob/living/carbon/human/species/human/northern/thief,
/turf/open/floor/rogue/herringbone,
/area/rogue/indoors/cave)
"BS" = (
/obj/machinery/light/rogue/candle/weak/l,
/turf/open/floor/rogue/herringbone,
/area/rogue/indoors/cave)
"Cn" = (
/obj/structure/mineral_door/wood/deadbolt{
	dir = 1
	},
/turf/open/floor/rogue/ruinedwood/turned,
/area/rogue/indoors/town)
"CV" = (
/obj/structure/table/wood/fancy/blue,
/obj/item/clothing/ring/aalloy,
/turf/open/floor/rogue/herringbone,
/area/rogue/indoors/cave)
"En" = (
/obj/machinery/light/rogue/hearth,
/obj/item/cooking/pan,
/turf/open/floor/rogue/ruinedwood/turned,
/area/rogue/indoors/town)
"Eu" = (
/obj/structure/closet/crate/chest/crate,
/obj/structure/closet/crate/chest/crate,
/obj/item/reagent_containers/powder/ozium,
/turf/open/floor/carpet/stellar,
/area/rogue/indoors/cave)
"EJ" = (
/obj/structure/flora/roguegrass/herb/random,
/turf/open/floor/rogue/grass,
/area/rogue/outdoors/woods/north)
"EP" = (
/obj/structure/flora/newtree,
/turf/open/floor/rogue/grass,
/area/rogue/outdoors/woods/north)
"GO" = (
/obj/effect/decal/cleanable/dirt/cobweb,
/turf/open/floor/rogue/herringbone,
/area/rogue/indoors/cave)
"Ij" = (
/mob/living/carbon/human/species/human/northern/thief,
/obj/structure/chair/wood/rogue/chair5,
/turf/open/floor/carpet/royalblack,
/area/rogue/indoors/cave)
"Jt" = (
/turf/closed/wall/mineral/rogue/decowood,
/area/rogue/indoors/town)
"JN" = (
/obj/item/reagent_containers/powder/salt,
/turf/open/floor/carpet/royalblack,
/area/rogue/indoors/cave)
"Lr" = (
/obj/effect/decal/cleanable/debris/stony,
/turf/open/floor/carpet/royalblack,
/area/rogue/indoors/cave)
"Mm" = (
/obj/effect/decal/cleanable/debris/stony,
/obj/effect/decal/cleanable/dirt/cobweb{
	dir = 4
	},
/turf/open/floor/carpet/royalblack,
/area/rogue/indoors/cave)
"NO" = (
/mob/living/carbon/human/species/human/northern/thief,
/obj/structure/chair/wood/rogue/chair5{
	dir = 1
	},
/turf/open/floor/rogue/herringbone,
/area/rogue/indoors/cave)
"Oz" = (
/obj/effect/decal/cleanable/debris/woody,
/turf/closed/wall/mineral/rogue/craftstone{
	density = 0
	},
/area/rogue/indoors/cave)
"OR" = (
/obj/effect/decal/cleanable/debris/stony,
/turf/open/floor/rogue/herringbone,
/area/rogue/indoors/cave)
"PQ" = (
/obj/structure/roguewindow,
/turf/open/floor/rogue/ruinedwood/turned,
/area/rogue/indoors/town)
"QI" = (
/turf/closed/wall/mineral/rogue/stone,
/area/rogue/indoors/town)
"RN" = (
/turf/open/floor/rogue/rooftop/green/north,
/area/rogue/outdoors/mountains)
"Ux" = (
/turf/open/floor/carpet/royalblack,
/area/rogue/indoors/cave)
"Vs" = (
/obj/structure/chair/wood/rogue/chair5{
	dir = 1
	},
/turf/open/floor/rogue/herringbone,
/area/rogue/indoors/cave)
"VX" = (
/turf/closed/mineral/random/rogue,
/area/rogue/indoors/cave)
"WY" = (
/obj/structure/closet/crate/chest/crate,
/obj/effect/decal/cleanable/debris/woody,
/obj/effect/decal/cleanable/debris/stony,
/obj/item/reagent_containers/powder/moondust,
/turf/open/floor/carpet/stellar,
/area/rogue/indoors/cave)
"WZ" = (
/turf/closed/wall/mineral/rogue/craftstone,
/area/rogue/indoors/cave)
"Xl" = (
/obj/structure/mineral_door/wood/deadbolt{
	dir = 4
	},
/turf/open/floor/rogue/ruinedwood/turned,
/area/rogue/indoors/town)
"Yd" = (
/obj/structure/table/wood/poor,
/obj/item/natural/clay/clayfancyvase{
	pixel_y = 9;
	pixel_x = -7
	},
/turf/open/floor/rogue/ruinedwood/turned,
/area/rogue/indoors/town)
"ZL" = (
/obj/structure/trap/wall_projectile{
	dir = 1
	},
/turf/open/floor/carpet/royalblack,
/area/rogue/indoors/town)

(1,1,1) = {"
VX
hi
av
zM
hi
VX
"}
(2,1,1) = {"
VX
hH
zM
WY
Eu
VX
"}
(3,1,1) = {"
WZ
WZ
WZ
Oz
WZ
WZ
"}
(4,1,1) = {"
WZ
GO
uT
fC
BS
WZ
"}
(5,1,1) = {"
WZ
to
dH
CV
Vs
WZ
"}
(6,1,1) = {"
WZ
ld
yB
na
NO
WZ
"}
(7,1,1) = {"
WZ
Ij
na
wZ
Vs
WZ
"}
(8,1,1) = {"
WZ
Lr
Ux
AX
OR
WZ
"}
(9,1,1) = {"
WZ
hX
Lr
Ux
pF
WZ
"}
(10,1,1) = {"
WZ
cJ
WZ
WZ
WZ
WZ
"}
(11,1,1) = {"
WZ
dU
ky
zR
Mm
WZ
"}
(12,1,1) = {"
WZ
tr
Ux
Lr
JN
WZ
"}
(13,1,1) = {"
WZ
WZ
WZ
WZ
WZ
WZ
"}

(1,1,2) = {"
vy
Jt
Jt
Jt
Jt
vy
"}
(2,1,2) = {"
Jt
Yd
kE
yp
fu
PQ
"}
(3,1,2) = {"
Jt
ng
yp
yp
yp
Jt
"}
(4,1,2) = {"
Jt
yp
yp
yp
ZL
Cn
"}
(5,1,2) = {"
Jt
iD
yp
yp
En
PQ
"}
(6,1,2) = {"
vy
QI
Xl
QI
au
vy
"}
(7,1,2) = {"
Jt
bo
yp
yp
QI
yN
"}
(8,1,2) = {"
QI
yM
yp
yp
QI
eA
"}
(9,1,2) = {"
Jt
lF
yp
tM
QI
or
"}
(10,1,2) = {"
vy
Jt
au
uw
au
au
"}
(11,1,2) = {"
zO
EP
au
jQ
jz
au
"}
(12,1,2) = {"
ok
EP
au
au
au
au
"}
(13,1,2) = {"
yN
EJ
yN
EP
yN
gn
"}

(1,1,3) = {"
hu
hu
RN
RN
RN
RN
"}
(2,1,3) = {"
hu
hu
RN
RN
RN
RN
"}
(3,1,3) = {"
hu
hu
RN
RN
RN
RN
"}
(4,1,3) = {"
hu
hu
RN
RN
RN
RN
"}
(5,1,3) = {"
hu
hu
RN
RN
RN
RN
"}
(6,1,3) = {"
hu
hu
RN
RN
RN
RN
"}
(7,1,3) = {"
hu
hu
RN
RN
RN
eu
"}
(8,1,3) = {"
hu
hu
RN
RN
RN
eu
"}
(9,1,3) = {"
hu
hu
RN
RN
RN
eu
"}
(10,1,3) = {"
hu
hu
RN
RN
RN
eu
"}
(11,1,3) = {"
sg
sg
RN
RN
RN
eu
"}
(12,1,3) = {"
sg
sg
RN
RN
RN
eu
"}
(13,1,3) = {"
sg
sg
eu
eu
eu
eu
"}
