//MAP CONVERTED BY dmm2tgm.py THIS HEADER COMMENT PREVENTS RECONVERSION, DO NOT REMOVE
"a" = (
/turf/closed/wall/mineral/rogue/decowood,
/area/rogue/indoors/town)
"b" = (
/obj/structure/flora/roguegrass,
/turf/open/floor/rogue/dirt,
/area/rogue/outdoors/woods/north)
"c" = (
/turf/closed/wall/mineral/rogue/stone,
/area/rogue/indoors/town)
"d" = (
/turf/open/floor/rogue/rooftop/green/north,
/area/rogue/outdoors/beach/forest/south)
"e" = (
/turf/closed/wall/mineral/rogue/wooddark/slitted,
/area/rogue/indoors/town)
"f" = (
/turf/open/floor/rogue/dirt,
/area/rogue/outdoors/woods/north)
"h" = (
/turf/open/transparent/openspace,
/area/rogue/outdoors/beach/forest/south)
"j" = (
/obj/structure/table/wood/poor,
/obj/item/clothing/ring/aalloy,
/turf/open/floor/rogue/ruinedwood/turned,
/area/rogue/indoors/town)
"k" = (
/turf/closed/wall/mineral/rogue/craftstone,
/area/rogue/indoors/town)
"l" = (
/obj/structure/flora/roguegrass,
/turf/open/floor/rogue/grass,
/area/rogue/outdoors/woods/north)
"m" = (
/obj/structure/bed/rogue/inn,
/obj/item/bedsheet/rogue/wool,
/mob/living/carbon/human/species/human/northern/thief,
/turf/open/floor/carpet/royalblack,
/area/rogue/indoors/town)
"n" = (
/obj/structure/table/wood/poor,
/obj/item/natural/clay/clayfancyvase,
/turf/open/floor/rogue/ruinedwood/turned,
/area/rogue/indoors/town)
"o" = (
/turf/open/floor/rogue/rooftop/green/north,
/area/rogue/outdoors/mountains)
"p" = (
/obj/structure/roguewindow,
/turf/open/floor/rogue/ruinedwood/turned,
/area/rogue/indoors/town)
"q" = (
/obj/structure/closet/crate/chest/crate,
/obj/item/clothing/suit/roguetown/shirt/tunic/black,
/obj/item/clothing/under/roguetown/trou,
/turf/open/floor/rogue/ruinedwood/turned,
/area/rogue/indoors/town)
"s" = (
/obj/structure/mineral_door/wood/deadbolt{
	dir = 1
	},
/turf/open/floor/rogue/ruinedwood/turned,
/area/rogue/indoors/town)
"v" = (
/obj/structure/trap/shock,
/turf/open/floor/carpet/royalblack,
/area/rogue/indoors/town)
"w" = (
/obj/structure/mineral_door/wood/deadbolt{
	dir = 4
	},
/turf/open/floor/rogue/ruinedwood/turned,
/area/rogue/indoors/town)
"x" = (
/obj/structure/flora/roguegrass/herb/random,
/turf/open/floor/rogue/grass,
/area/rogue/outdoors/woods/north)
"y" = (
/obj/structure/chair/wood/rogue{
	dir = 8
	},
/turf/open/floor/rogue/ruinedwood/turned,
/area/rogue/indoors/town)
"z" = (
/obj/structure/flora/roguegrass,
/obj/structure/flora/roguegrass/herb/random,
/turf/open/floor/rogue/grass,
/area/rogue/outdoors/woods/north)
"F" = (
/obj/machinery/light/rogue/hearth,
/obj/item/cooking/pan,
/turf/open/floor/rogue/ruinedwood/turned,
/area/rogue/indoors/town)
"I" = (
/turf/open/transparent/openspace,
/area/rogue/outdoors/mountains)
"J" = (
/obj/machinery/light/rogue/campfire/fireplace{
	pixel_y = 32
	},
/turf/open/floor/rogue/ruinedwood/turned,
/area/rogue/indoors/town)
"K" = (
/turf/closed/wall/mineral/rogue/craftstone{
	density = 0
	},
/area/rogue/indoors/town)
"M" = (
/obj/structure/chair/wood/rogue{
	dir = 1
	},
/turf/open/floor/rogue/ruinedwood/turned,
/area/rogue/indoors/town)
"N" = (
/obj/structure/rack/rogue,
/obj/item/clothing/gloves/roguetown/leather,
/obj/item/clothing/head/roguetown/fisherhat,
/turf/open/floor/rogue/ruinedwood/turned,
/area/rogue/indoors/town)
"O" = (
/turf/closed/mineral/rogue/bedrock,
/area/rogue/indoors/cave)
"P" = (
/obj/structure/trap/wall_projectile{
	dir = 1
	},
/turf/open/floor/carpet/royalblack,
/area/rogue/indoors/town)
"Q" = (
/obj/structure/flora/newtree,
/turf/open/floor/rogue/grass,
/area/rogue/outdoors/woods/north)
"R" = (
/obj/structure/ladder,
/turf/open/floor/rogue/naturalstone,
/area/rogue/indoors/cave)
"S" = (
/turf/open/floor/rogue/grass,
/area/rogue/outdoors/woods/north)
"T" = (
/turf/closed/mineral/random/rogue,
/area/rogue/indoors/cave)
"V" = (
/turf/open/floor/rogue/ruinedwood/turned,
/area/rogue/indoors/town)
"X" = (
/obj/structure/closet/crate/chest/crate,
/obj/item/roguecoin/gold,
/obj/item/roguecoin/gold,
/obj/item/candle/candlestick/gold/single,
/turf/open/floor/rogue/naturalstone,
/area/rogue/indoors/cave)
"Z" = (
/obj/structure/ladder,
/turf/open/floor/rogue/ruinedwood/turned,
/area/rogue/indoors/town)

(1,1,1) = {"
T
T
T
T
T
T
"}
(2,1,1) = {"
T
T
T
T
T
T
"}
(3,1,1) = {"
T
T
T
T
T
T
"}
(4,1,1) = {"
T
T
T
T
T
T
"}
(5,1,1) = {"
T
T
T
T
T
T
"}
(6,1,1) = {"
T
T
T
T
T
T
"}
(7,1,1) = {"
T
T
T
T
T
T
"}
(8,1,1) = {"
T
T
T
T
T
T
"}
(9,1,1) = {"
T
T
T
T
T
T
"}
(10,1,1) = {"
T
T
O
O
O
T
"}
(11,1,1) = {"
T
T
O
R
O
T
"}
(12,1,1) = {"
T
T
O
X
O
T
"}
(13,1,1) = {"
T
T
O
O
O
T
"}

(1,1,2) = {"
e
a
a
a
a
e
"}
(2,1,2) = {"
a
n
M
V
N
p
"}
(3,1,2) = {"
a
y
V
V
V
a
"}
(4,1,2) = {"
a
V
V
V
P
s
"}
(5,1,2) = {"
a
q
V
V
F
p
"}
(6,1,2) = {"
e
c
w
c
k
e
"}
(7,1,2) = {"
a
j
V
V
c
x
"}
(8,1,2) = {"
c
J
V
V
c
l
"}
(9,1,2) = {"
a
m
V
v
c
l
"}
(10,1,2) = {"
e
a
k
K
k
S
"}
(11,1,2) = {"
z
Q
k
Z
k
S
"}
(12,1,2) = {"
b
Q
k
k
k
f
"}
(13,1,2) = {"
S
S
S
S
S
f
"}

(1,1,3) = {"
d
d
o
o
o
o
"}
(2,1,3) = {"
d
d
o
o
o
o
"}
(3,1,3) = {"
d
d
o
o
o
o
"}
(4,1,3) = {"
d
d
o
o
o
o
"}
(5,1,3) = {"
d
d
o
o
o
o
"}
(6,1,3) = {"
d
d
o
o
o
o
"}
(7,1,3) = {"
d
d
o
o
o
I
"}
(8,1,3) = {"
d
d
o
o
o
I
"}
(9,1,3) = {"
d
d
o
o
o
I
"}
(10,1,3) = {"
d
d
o
o
o
I
"}
(11,1,3) = {"
h
h
o
o
o
I
"}
(12,1,3) = {"
h
h
o
o
o
I
"}
(13,1,3) = {"
h
h
I
I
I
I
"}
