//MAP CONVERTED BY dmm2tgm.py THIS HEADER COMMENT PREVENTS RECONVERSION, DO NOT REMOVE
"a" = (
/obj/structure/fluff/railing/border/west,
/turf/open/transparent/openspace,
/area/rogue/outdoors/woods/south)
"c" = (
/turf/open/floor/rogue/rooftop/green/west,
/area/rogue/outdoors/mountains)
"d" = (
/obj/structure/stairs,
/turf/open/floor/rogue/dirt/road,
/area/rogue/outdoors/woods/south)
"e" = (
/obj/structure/flora/roguegrass/water/reeds,
/turf/open/transparent/openspace,
/area/rogue/outdoors/woods/south)
"f" = (
/turf/closed/wall/mineral/rogue/roofwall/outercorner,
/area/rogue/outdoors/mountains)
"g" = (
/obj/structure/fluff/railing/wood/east,
/turf/open/floor/rogue/ruinedwood/turned,
/area/rogue/outdoors/woods/south)
"h" = (
/turf/closed/wall/mineral/rogue/roofwall/outercorner/dir1,
/area/rogue/outdoors/mountains)
"i" = (
/turf/closed/wall/mineral/rogue/roofwall/middle/dir4,
/area/rogue/outdoors/mountains)
"l" = (
/obj/structure/fluff/railing/wood/west,
/turf/open/floor/rogue/twig,
/area/rogue/outdoors/woods/south)
"m" = (
/obj/structure/stairs{
	dir = 1
	},
/turf/open/floor/rogue/dirt,
/area/rogue/outdoors/woods/south)
"p" = (
/turf/closed/wall/mineral/rogue/roofwall/outercorner/dir4,
/area/rogue/outdoors/mountains)
"r" = (
/turf/open/transparent/openspace,
/area/rogue/outdoors/mountains)
"s" = (
/turf/open/floor/rogue/rooftop/green/east,
/area/rogue/outdoors/mountains)
"t" = (
/obj/structure/fluff/railing/border/east,
/turf/open/floor/rogue/dirt,
/area/rogue/outdoors/woods/south)
"u" = (
/obj/structure/fluff/railing/border/east,
/turf/open/floor/rogue/naturalstone,
/area/rogue/outdoors/woods/south)
"w" = (
/obj/structure/fluff/railing/border/west,
/obj/item/restraints/legcuffs/beartrap/armed/camouflage,
/turf/open/floor/rogue/naturalstone,
/area/rogue/outdoors/woods/south)
"C" = (
/obj/structure/fluff/railing/wood/west,
/turf/open/floor/rogue/ruinedwood/turned,
/area/rogue/outdoors/woods/south)
"H" = (
/obj/structure/fluff/railing/border/west,
/turf/open/floor/rogue/naturalstone,
/area/rogue/outdoors/woods/south)
"J" = (
/obj/structure/fluff/railing/border/east,
/turf/open/transparent/openspace,
/area/rogue/outdoors/woods/south)
"M" = (
/turf/closed/wall/mineral/rogue/stonebrick,
/area/rogue/outdoors/woods/south)
"O" = (
/turf/open/floor/rogue/twig,
/area/rogue/outdoors/woods/south)
"Q" = (
/obj/structure/fluff/railing/border/east,
/obj/item/restraints/legcuffs/beartrap/armed/camouflage,
/turf/open/floor/rogue/dirt,
/area/rogue/outdoors/woods/south)
"R" = (
/turf/closed/wall/mineral/rogue/roofwall/middle/dir8,
/area/rogue/outdoors/mountains)
"S" = (
/turf/open/transparent/openspace,
/area/rogue/outdoors/woods/south)
"T" = (
/obj/structure/stairs{
	dir = 1
	},
/turf/open/floor/rogue/naturalstone,
/area/rogue/outdoors/woods/south)
"Y" = (
/turf/closed/wall/mineral/rogue/roofwall/outercorner/dir8,
/area/rogue/outdoors/mountains)

(1,1,1) = {"
M
Q
t
J
S
S
e
u
u
t
M
"}
(2,1,1) = {"
d
C
C
l
S
S
S
C
C
C
m
"}
(3,1,1) = {"
d
g
g
O
S
S
O
O
g
g
T
"}
(4,1,1) = {"
M
w
a
S
S
S
a
a
H
H
M
"}

(1,1,2) = {"
c
c
c
c
c
c
c
c
c
c
c
"}
(2,1,2) = {"
f
R
R
R
R
R
R
R
R
R
p
"}
(3,1,2) = {"
h
i
i
i
i
i
i
i
i
i
Y
"}
(4,1,2) = {"
s
s
s
s
s
s
s
s
s
s
s
"}

(1,1,3) = {"
r
r
r
r
r
r
r
r
r
r
r
"}
(2,1,3) = {"
r
r
r
r
r
r
r
r
r
r
r
"}
(3,1,3) = {"
r
r
r
r
r
r
r
r
r
r
r
"}
(4,1,3) = {"
r
r
r
r
r
r
r
r
r
r
r
"}
