//MAP CONVERTED BY dmm2tgm.py THIS HEADER COMMENT PREVENTS RECONVERSION, DO NOT REMOVE
"a" = (
/turf/open/floor/rogue/naturalstone,
/area/rogue/outdoors/woods/south)
"d" = (
/turf/open/floor/rogue/dirt/road,
/area/rogue/outdoors/woods/south)
"e" = (
/obj/item/natural/bundle/stick{
	pixel_y = -6;
	pixel_x = 6
	},
/turf/open/floor/rogue/twig,
/area/rogue/outdoors/woods/south)
"f" = (
/obj/item/grown/log/tree/small,
/turf/open/floor/rogue/twig,
/area/rogue/outdoors/woods/south)
"g" = (
/obj/item/natural/bundle/stick,
/turf/open/floor/rogue/twig,
/area/rogue/outdoors/woods/south)
"i" = (
/obj/item/natural/bundle/stick,
/turf/open/floor/rogue/twig,
/area/rogue/outdoors/mountains)
"p" = (
/turf/open/floor/rogue/twig,
/area/rogue/outdoors/mountains)
"r" = (
/turf/open/transparent/openspace,
/area/rogue/outdoors/mountains)
"s" = (
/obj/item/natural/stone{
	pixel_x = 7;
	pixel_y = -14
	},
/turf/open/floor/rogue/naturalstone,
/area/rogue/outdoors/woods/south)
"t" = (
/obj/item/natural/stone{
	pixel_y = 5;
	pixel_x = -8
	},
/obj/structure/fluff/railing/border/east,
/turf/open/floor/rogue/dirt,
/area/rogue/outdoors/woods/south)
"u" = (
/obj/structure/fluff/railing/border/east,
/turf/open/floor/rogue/naturalstone,
/area/rogue/outdoors/woods/south)
"w" = (
/obj/item/restraints/legcuffs/beartrap/armed/camouflage,
/turf/open/floor/rogue/naturalstone,
/area/rogue/outdoors/woods/south)
"C" = (
/turf/open/floor/rogue/dirt,
/area/rogue/outdoors/woods/south)
"H" = (
/obj/item/natural/stone{
	pixel_y = -10;
	pixel_x = 5
	},
/obj/structure/fluff/signage{
	name = "I'M NOT FINISHING THIS!!!"
	},
/turf/open/floor/rogue/dirt,
/area/rogue/outdoors/woods/south)
"M" = (
/obj/item/natural/stone,
/turf/closed/wall/mineral/rogue/wooddark,
/area/rogue/outdoors/woods/south)
"O" = (
/turf/open/floor/rogue/twig,
/area/rogue/outdoors/woods/south)
"Q" = (
/obj/item/restraints/legcuffs/beartrap/armed/camouflage,
/turf/open/floor/rogue/dirt,
/area/rogue/outdoors/woods/south)
"R" = (
/obj/item/grown/log/tree/small{
	pixel_y = -12;
	pixel_x = -11
	},
/turf/open/floor/rogue/twig,
/area/rogue/outdoors/woods/south)
"S" = (
/turf/open/transparent/openspace,
/area/rogue/outdoors/woods/south)
"T" = (
/obj/item/grown/log/tree{
	pixel_x = -4;
	pixel_y = 6
	},
/turf/open/floor/rogue/twig,
/area/rogue/outdoors/woods/south)

(1,1,1) = {"
a
Q
C
S
S
S
S
u
u
t
M
"}
(2,1,1) = {"
d
C
C
S
S
S
S
a
e
R
O
"}
(3,1,1) = {"
d
C
C
S
S
S
S
O
g
f
T
"}
(4,1,1) = {"
a
w
S
S
S
S
S
a
H
s
M
"}

(1,1,2) = {"
r
r
r
r
r
r
p
p
p
p
p
"}
(2,1,2) = {"
r
r
r
r
r
p
p
p
p
p
p
"}
(3,1,2) = {"
r
r
r
r
r
i
p
p
p
p
p
"}
(4,1,2) = {"
r
r
r
r
r
r
p
p
p
p
p
"}

(1,1,3) = {"
r
r
r
r
r
r
r
r
r
r
r
"}
(2,1,3) = {"
r
r
r
r
r
r
r
r
r
r
r
"}
(3,1,3) = {"
r
r
r
r
r
r
r
r
r
r
r
"}
(4,1,3) = {"
r
r
r
r
r
r
r
r
r
r
r
"}
