//MAP CONVERTED BY dmm2tgm.py THIS HEADER COMMENT PREVENTS RECONVERSION, DO NOT REMOVE
"a" = (
/obj/structure/fluff/railing/border/west,
/turf/open/transparent/openspace,
/area/rogue/outdoors/woods/south)
"c" = (
/turf/open/floor/rogue/rooftop/green/west,
/area/rogue/outdoors/mountains)
"d" = (
/obj/structure/stairs,
/turf/open/floor/rogue/dirt/road,
/area/rogue/outdoors/woods/south)
"e" = (
/turf/open/floor/rogue/ruinedwood/turned,
/area/rogue/outdoors/woods/south)
"f" = (
/turf/closed/wall/mineral/rogue/roofwall/outercorner,
/area/rogue/outdoors/mountains)
"g" = (
/obj/structure/fluff/railing/wood/east,
/turf/open/floor/rogue/ruinedwood/turned,
/area/rogue/outdoors/woods/south)
"h" = (
/turf/closed/wall/mineral/rogue/roofwall/outercorner/dir1,
/area/rogue/outdoors/mountains)
"i" = (
/turf/closed/wall/mineral/rogue/roofwall/middle/dir4,
/area/rogue/outdoors/mountains)
"l" = (
/obj/structure/fluff/railing/border/east,
/obj/structure/fluff/railing/wood/east,
/turf/open/floor/rogue/ruinedwood/turned,
/area/rogue/outdoors/woods/south)
"m" = (
/obj/structure/stairs{
	dir = 1
	},
/turf/open/floor/rogue/dirt,
/area/rogue/outdoors/woods/south)
"p" = (
/turf/closed/wall/mineral/rogue/roofwall/outercorner/dir4,
/area/rogue/outdoors/mountains)
"r" = (
/turf/open/transparent/openspace,
/area/rogue/outdoors/mountains)
"s" = (
/turf/open/floor/rogue/rooftop/green/east,
/area/rogue/outdoors/mountains)
"t" = (
/obj/structure/fluff/railing/border/east,
/turf/open/floor/rogue/dirt,
/area/rogue/outdoors/woods/south)
"u" = (
/obj/structure/fluff/railing/border/east,
/turf/open/floor/rogue/naturalstone,
/area/rogue/outdoors/woods/south)
"w" = (
/obj/structure/fluff/railing/border/east,
/obj/item/restraints/legcuffs/beartrap/armed/camouflage,
/obj/machinery/light/rogue/torchholder/c,
/turf/open/floor/rogue/dirt,
/area/rogue/outdoors/woods/south)
"x" = (
/obj/structure/fluff/railing/border/west,
/obj/machinery/light/rogue/torchholder{
	dir = 1
	},
/turf/open/floor/rogue/naturalstone,
/area/rogue/outdoors/woods/south)
"A" = (
/obj/structure/fluff/railing/border/west,
/obj/structure/fluff/railing/border,
/turf/open/transparent/openspace,
/area/rogue/outdoors/woods/south)
"C" = (
/obj/structure/fluff/railing/wood/west,
/turf/open/floor/rogue/ruinedwood/turned,
/area/rogue/outdoors/woods/south)
"H" = (
/obj/structure/fluff/railing/border/west,
/turf/open/floor/rogue/naturalstone,
/area/rogue/outdoors/woods/south)
"J" = (
/obj/structure/fluff/railing/border/east,
/turf/open/transparent/openspace,
/area/rogue/outdoors/woods/south)
"M" = (
/turf/closed/wall/mineral/rogue/stonebrick,
/area/rogue/outdoors/woods/south)
"N" = (
/obj/structure/fluff/railing/border/north,
/obj/structure/fluff/railing/border/east,
/obj/structure/fluff/railing/wood/east,
/turf/open/transparent/openspace,
/area/rogue/outdoors/woods/south)
"O" = (
/obj/structure/fluff/railing/border/east,
/obj/structure/fluff/railing/border,
/obj/structure/fluff/railing/wood/east,
/turf/open/floor/rogue/ruinedwood/turned,
/area/rogue/outdoors/woods/south)
"Q" = (
/obj/structure/fluff/railing/border/east,
/obj/item/restraints/legcuffs/beartrap/armed/camouflage,
/turf/open/floor/rogue/dirt,
/area/rogue/outdoors/woods/south)
"R" = (
/turf/closed/wall/mineral/rogue/roofwall/middle/dir8,
/area/rogue/outdoors/mountains)
"S" = (
/turf/open/transparent/openspace,
/area/rogue/outdoors/woods/south)
"T" = (
/obj/structure/stairs{
	dir = 1
	},
/turf/open/floor/rogue/naturalstone,
/area/rogue/outdoors/woods/south)
"Y" = (
/turf/closed/wall/mineral/rogue/roofwall/outercorner/dir8,
/area/rogue/outdoors/mountains)
"Z" = (
/obj/structure/fluff/railing/border/east,
/obj/structure/fluff/railing/border,
/obj/structure/fluff/railing/wood/east,
/turf/open/transparent/openspace,
/area/rogue/outdoors/woods/south)

(1,1,1) = {"
M
w
t
J
S
S
J
u
u
Q
M
"}
(2,1,1) = {"
d
C
C
C
N
Z
C
C
C
C
m
"}
(3,1,1) = {"
d
g
g
g
e
e
g
g
g
g
T
"}
(4,1,1) = {"
M
H
a
A
l
O
a
a
H
x
M
"}

(1,1,2) = {"
c
c
c
c
c
c
c
c
c
c
c
"}
(2,1,2) = {"
f
R
R
R
R
R
R
R
R
R
p
"}
(3,1,2) = {"
h
i
i
i
i
i
i
i
i
i
Y
"}
(4,1,2) = {"
s
s
s
s
s
s
s
s
s
s
s
"}

(1,1,3) = {"
r
r
r
r
r
r
r
r
r
r
r
"}
(2,1,3) = {"
r
r
r
r
r
r
r
r
r
r
r
"}
(3,1,3) = {"
r
r
r
r
r
r
r
r
r
r
r
"}
(4,1,3) = {"
r
r
r
r
r
r
r
r
r
r
r
"}
