//MAP CONVERTED BY dmm2tgm.py THIS HEADER COMMENT PREVENTS RECONVERSION, DO NOT REMOVE
"a" = (
/obj/structure/closet/crate/roguecloset,
/obj/effect/spawner/lootdrop/cheap_jewelry_spawner,
/turf/open/floor/rogue/ruinedwood,
/area/rogue/indoors)
"b" = (
/obj/structure/mineral_door/wood/deadbolt{
	dir = 8
	},
/turf/open/floor/rogue/ruinedwood,
/area/rogue/indoors)
"c" = (
/obj/structure/fluff/railing/corner/south_west,
/turf/open/transparent/openspace,
/area/rogue/indoors)
"d" = (
/obj/structure/fluff/railing/border/west,
/turf/open/transparent/openspace,
/area/rogue/indoors)
"f" = (
/obj/structure/fluff/railing/border,
/turf/open/transparent/openspace,
/area/rogue/indoors)
"g" = (
/obj/structure/chair/wood/rogue{
	dir = 4
	},
/turf/open/floor/rogue/ruinedwood,
/area/rogue/indoors)
"h" = (
/turf/open/floor/rogue/rooftop/green/east,
/area/rogue/outdoors/mountains)
"j" = (
/turf/open/floor/rogue/ruinedwood,
/area/rogue/indoors)
"m" = (
/obj/structure/bed/rogue/inn/wool,
/obj/item/bedsheet/rogue/pelt,
/turf/open/floor/rogue/ruinedwood,
/area/rogue/indoors)
"q" = (
/obj/machinery/light/rogue/candle/l,
/turf/open/floor/rogue/ruinedwood,
/area/rogue/indoors)
"r" = (
/obj/structure/roguewindow,
/turf/open/floor/rogue/ruinedwood,
/area/rogue/indoors)
"u" = (
/turf/open/transparent/openspace,
/area/rogue/indoors)
"v" = (
/mob/living/carbon/human/species/skeleton/npc/mediumspread,
/obj/machinery/light/rogue/campfire/fireplace{
	pixel_y = 32
	},
/turf/open/floor/rogue/ruinedwood,
/area/rogue/indoors)
"w" = (
/obj/item/bedsheet/rogue/double_pelt,
/obj/structure/bed/rogue/inn/wooldouble,
/turf/open/floor/rogue/ruinedwood,
/area/rogue/indoors)
"x" = (
/obj/structure/chair/wood/rogue/chair3{
	dir = 1
	},
/turf/open/floor/rogue/ruinedwood,
/area/rogue/indoors)
"y" = (
/obj/structure/chair/wood/rogue{
	dir = 8
	},
/turf/open/floor/rogue/ruinedwood,
/area/rogue/indoors)
"E" = (
/obj/structure/table/wood/poor,
/turf/open/floor/rogue/ruinedwood,
/area/rogue/indoors)
"F" = (
/obj/machinery/light/rogue/chand,
/turf/open/transparent/openspace,
/area/rogue/indoors)
"G" = (
/turf/open/floor/rogue/rooftop/green/north,
/area/rogue/outdoors/town/roofs)
"K" = (
/obj/structure/stairs{
	dir = 8
	},
/obj/structure/fluff/railing/border,
/turf/open/floor/rogue/ruinedwood,
/area/rogue/indoors)
"M" = (
/obj/structure/chair/wood/rogue/chair3,
/turf/open/floor/rogue/ruinedwood,
/area/rogue/indoors)
"N" = (
/turf/closed/wall/mineral/rogue/wooddark,
/area/rogue/indoors)
"O" = (
/obj/machinery/light/rogue/campfire/fireplace{
	pixel_y = 32
	},
/turf/open/floor/rogue/ruinedwood,
/area/rogue/indoors)
"Q" = (
/turf/closed/wall/mineral/rogue/decowood,
/area/rogue/indoors)
"S" = (
/obj/item/bedsheet/rogue/pelt,
/obj/structure/bed/rogue/inn/wool,
/turf/open/floor/rogue/ruinedwood,
/area/rogue/indoors)
"T" = (
/obj/structure/closet/crate/roguecloset,
/turf/open/floor/rogue/ruinedwood,
/area/rogue/indoors)
"U" = (
/obj/structure/table/wood/poor,
/obj/item/trash/candle,
/turf/open/floor/rogue/ruinedwood,
/area/rogue/indoors)
"X" = (
/turf/open/transparent/openspace,
/area/rogue/outdoors/mountains)

(1,1,1) = {"
X
X
X
X
X
X
X
X
X
X
X
X
X
"}
(2,1,1) = {"
X
N
Q
r
N
Q
r
Q
N
r
Q
N
X
"}
(3,1,1) = {"
X
Q
T
j
Q
a
j
g
Q
j
T
Q
X
"}
(4,1,1) = {"
X
Q
O
j
Q
v
j
U
Q
O
j
Q
X
"}
(5,1,1) = {"
X
Q
m
j
Q
w
j
y
Q
j
S
Q
X
"}
(6,1,1) = {"
X
N
Q
b
N
Q
b
Q
N
b
Q
N
X
"}
(7,1,1) = {"
X
Q
j
j
q
j
j
j
q
j
j
Q
X
"}
(8,1,1) = {"
X
Q
K
j
j
j
j
j
j
j
j
Q
X
"}
(9,1,1) = {"
X
Q
f
M
E
x
j
j
M
E
x
Q
X
"}
(10,1,1) = {"
X
Q
c
d
d
d
d
d
d
d
d
Q
X
"}
(11,1,1) = {"
X
Q
u
u
u
u
u
u
u
u
u
Q
X
"}
(12,1,1) = {"
X
Q
u
u
u
F
u
N
Q
Q
Q
N
X
"}
(13,1,1) = {"
X
N
N
u
u
u
u
Q
h
h
h
h
X
"}
(14,1,1) = {"
X
X
N
r
r
N
Q
N
h
h
h
h
X
"}
(15,1,1) = {"
X
X
h
h
h
X
X
X
X
X
X
X
X
"}
(16,1,1) = {"
X
X
h
h
h
X
X
X
X
X
X
X
X
"}
(17,1,1) = {"
X
X
X
X
X
X
X
X
X
X
X
X
X
"}

(1,1,2) = {"
X
X
X
X
X
X
X
X
X
X
X
X
X
"}
(2,1,2) = {"
X
N
Q
r
N
Q
r
Q
N
r
Q
N
X
"}
(3,1,2) = {"
X
Q
T
j
Q
a
j
g
Q
j
T
Q
X
"}
(4,1,2) = {"
X
Q
O
j
Q
v
j
U
Q
O
j
Q
X
"}
(5,1,2) = {"
X
Q
m
j
Q
w
j
y
Q
j
S
Q
X
"}
(6,1,2) = {"
X
N
Q
b
N
Q
b
Q
N
b
Q
N
X
"}
(7,1,2) = {"
X
Q
j
j
q
j
j
j
q
j
j
Q
X
"}
(8,1,2) = {"
X
Q
K
j
j
j
j
j
j
j
j
Q
X
"}
(9,1,2) = {"
X
Q
f
M
E
x
j
j
M
E
x
Q
X
"}
(10,1,2) = {"
X
Q
c
d
d
d
d
d
d
d
d
Q
X
"}
(11,1,2) = {"
X
Q
u
u
u
u
u
u
u
u
u
Q
X
"}
(12,1,2) = {"
X
Q
u
u
u
F
u
N
Q
Q
Q
N
X
"}
(13,1,2) = {"
X
N
N
u
u
u
u
Q
h
h
h
h
X
"}
(14,1,2) = {"
X
X
N
r
r
N
Q
N
h
h
h
h
X
"}
(15,1,2) = {"
X
X
h
h
h
X
X
X
X
X
X
X
X
"}
(16,1,2) = {"
X
X
h
h
h
X
X
X
X
X
X
X
X
"}
(17,1,2) = {"
X
X
X
X
X
X
X
X
X
X
X
X
X
"}

(1,1,3) = {"
X
X
X
X
X
X
X
X
X
X
X
X
X
"}
(2,1,3) = {"
X
G
G
G
G
G
G
G
G
G
G
G
X
"}
(3,1,3) = {"
X
G
G
G
G
G
G
G
G
G
G
G
X
"}
(4,1,3) = {"
X
G
G
G
G
G
G
G
G
G
G
G
X
"}
(5,1,3) = {"
X
G
G
G
G
G
G
G
G
G
G
G
X
"}
(6,1,3) = {"
X
G
G
G
G
G
G
G
G
G
G
G
X
"}
(7,1,3) = {"
X
G
G
G
G
G
G
G
G
G
G
G
X
"}
(8,1,3) = {"
X
G
G
G
G
G
G
G
G
G
G
G
X
"}
(9,1,3) = {"
X
G
G
G
G
G
G
G
G
G
G
G
X
"}
(10,1,3) = {"
X
G
G
G
G
G
G
G
G
G
G
G
X
"}
(11,1,3) = {"
X
G
G
G
G
G
G
G
G
G
G
G
X
"}
(12,1,3) = {"
X
G
G
G
G
G
G
G
G
G
G
G
X
"}
(13,1,3) = {"
X
G
G
G
G
G
G
G
X
X
X
X
X
"}
(14,1,3) = {"
X
X
G
G
G
G
G
G
X
X
X
X
X
"}
(15,1,3) = {"
X
X
X
X
X
X
X
X
X
X
X
X
X
"}
(16,1,3) = {"
X
X
X
X
X
X
X
X
X
X
X
X
X
"}
(17,1,3) = {"
X
X
X
X
X
X
X
X
X
X
X
X
X
"}
