//MAP CONVERTED BY dmm2tgm.py THIS HEADER COMMENT PREVENTS RECONVERSION, DO NOT REMOVE
"ac" = (
/turf/closed/wall/mineral/rogue/wooddark,
/area/rogue)
"ay" = (
/obj/structure/table/wood/poor,
/obj/item/reagent_containers/glass/cup/wooden,
/turf/open/floor/rogue/ruinedwood,
/area/rogue/indoors)
"aI" = (
/obj/structure/stairs{
	dir = 8
	},
/obj/structure/fluff/railing/border,
/turf/open/floor/rogue/ruinedwood,
/area/rogue)
"bp" = (
/obj/structure/fluff/railing/border,
/turf/open/floor/rogue/dirt,
/area/rogue/outdoors/mountains)
"cy" = (
/obj/structure/fermentation_keg/random/beer,
/turf/open/floor/rogue/ruinedwood,
/area/rogue/indoors)
"dp" = (
/obj/structure/mineral_door/wood/window,
/turf/open/floor/rogue/ruinedwood,
/area/rogue/indoors)
"eb" = (
/obj/structure/bed/rogue/inn/wool,
/obj/item/bedsheet/rogue/pelt,
/turf/open/floor/rogue/ruinedwood,
/area/rogue)
"fT" = (
/obj/structure/chair/wood/rogue/chair3,
/turf/open/floor/rogue/ruinedwood,
/area/rogue)
"gl" = (
/obj/structure/closet/crate/chest,
/obj/item/reagent_containers/food/snacks/rogue/meat/steak,
/obj/item/reagent_containers/food/snacks/rogue/meat/steak,
/obj/item/reagent_containers/food/snacks/rogue/meat/steak,
/turf/open/floor/rogue/hexstone,
/area/rogue/indoors)
"gw" = (
/obj/structure/fluff/railing/border/west,
/turf/open/floor/rogue/dirt,
/area/rogue/outdoors/mountains)
"ib" = (
/obj/structure/closet/crate/roguecloset,
/obj/effect/spawner/lootdrop/cheap_jewelry_spawner,
/turf/open/floor/rogue/ruinedwood,
/area/rogue)
"ja" = (
/obj/structure/fluff/railing/corner,
/turf/open/floor/rogue/hexstone,
/area/rogue/indoors)
"ka" = (
/obj/structure/chair/stool/rogue,
/obj/effect/landmark/start/courtagent,
/turf/open/floor/rogue/ruinedwood,
/area/rogue/indoors)
"kg" = (
/obj/structure/fluff/railing/border/north,
/turf/open/floor/rogue/dirt/road,
/area/rogue/outdoors/mountains)
"kr" = (
/turf/closed/wall/mineral/rogue/wooddark,
/area/rogue/indoors)
"kt" = (
/obj/structure/mineral_door/wood,
/turf/open/floor/rogue/ruinedwood,
/area/rogue/indoors)
"kC" = (
/turf/open/transparent/openspace,
/area/rogue)
"lo" = (
/obj/structure/fluff/railing/wood/north,
/turf/open/floor/rogue/twig,
/area/rogue/outdoors/mountains)
"lt" = (
/obj/structure/chair/wood/rogue{
	dir = 8
	},
/turf/open/floor/rogue/ruinedwood,
/area/rogue)
"mX" = (
/obj/structure/fluff/railing/corner/south_west,
/turf/open/transparent/openspace,
/area/rogue)
"nq" = (
/obj/structure/table/wood,
/obj/item/rogueweapon/huntingknife/stoneknife,
/turf/open/floor/rogue/hexstone,
/area/rogue/indoors)
"nD" = (
/turf/open/floor/rogue/grass,
/area/rogue/outdoors/woods/south)
"pb" = (
/obj/structure/rack/rogue,
/obj/item/reagent_containers/glass/cup/wooden,
/obj/item/reagent_containers/glass/cup/wooden,
/turf/open/floor/rogue/ruinedwood,
/area/rogue/indoors)
"pt" = (
/obj/structure/table/wood/poor,
/turf/open/floor/rogue/ruinedwood,
/area/rogue)
"pZ" = (
/obj/machinery/tanningrack,
/turf/open/floor/rogue/hexstone,
/area/rogue/indoors)
"qS" = (
/obj/effect/decal/remains/human,
/turf/open/floor/rogue/ruinedwood,
/area/rogue/indoors)
"rj" = (
/obj/structure/fluff/railing/corner,
/turf/open/floor/rogue/dirt/road,
/area/rogue/outdoors/mountains)
"rG" = (
/obj/machinery/light/rogue/hearth,
/obj/item/reagent_containers/glass/bucket/pot,
/turf/open/floor/rogue/hexstone,
/area/rogue/indoors)
"rT" = (
/obj/structure/fluff/railing/corner,
/turf/open/floor/rogue/ruinedwood,
/area/rogue/indoors)
"sg" = (
/obj/effect/decal/cleanable/blood,
/turf/open/floor/rogue/ruinedwood,
/area/rogue/indoors)
"sl" = (
/turf/closed/basic,
/area/rogue/outdoors/woods/south)
"tt" = (
/obj/structure/chair/wood/rogue/chair3{
	dir = 1
	},
/turf/open/floor/rogue/ruinedwood,
/area/rogue/indoors)
"tE" = (
/turf/open/floor/rogue/ruinedwood,
/area/rogue/indoors)
"tK" = (
/obj/structure/fluff/railing/corner/north_east,
/turf/open/floor/rogue/grass,
/area/rogue/outdoors/mountains)
"tT" = (
/mob/living/carbon/human/species/skeleton/npc/mediumspread,
/turf/open/floor/rogue/hexstone,
/area/rogue/indoors)
"tU" = (
/obj/item/millstone{
	pixel_y = 12
	},
/obj/structure/table/wood,
/turf/open/floor/rogue/hexstone,
/area/rogue/indoors)
"ub" = (
/obj/structure/fluff/railing/wood,
/turf/open/floor/rogue/twig,
/area/rogue/outdoors/mountains)
"uu" = (
/turf/closed/wall/mineral/rogue/stone/moss,
/area/rogue/indoors)
"uL" = (
/turf/open/floor/rogue/grassyel,
/area/rogue/outdoors/mountains)
"vm" = (
/turf/open/floor/rogue/ruinedwood,
/area/rogue)
"vQ" = (
/obj/structure/roguewindow,
/turf/open/floor/rogue/ruinedwood,
/area/rogue)
"vW" = (
/turf/open/floor/rogue/dirt,
/area/rogue/outdoors/mountains)
"wx" = (
/obj/effect/decal/cleanable/dirt/cobweb,
/obj/structure/rack/rogue,
/obj/item/reagent_containers/glass/cup/wooden,
/obj/item/reagent_containers/glass/cup/wooden,
/obj/item/reagent_containers/glass/cup/wooden,
/obj/machinery/light/rogue/candle/l,
/turf/open/floor/rogue/ruinedwood,
/area/rogue/indoors)
"xh" = (
/obj/structure/fluff/railing/border/west,
/turf/open/floor/rogue/hexstone,
/area/rogue/indoors)
"xy" = (
/turf/open/floor/rogue/hexstone,
/area/rogue/indoors)
"yh" = (
/turf/closed/wall/mineral/rogue/decowood,
/area/rogue/indoors)
"yF" = (
/obj/structure/table/wood,
/obj/item/cooking/platter,
/obj/item/kitchen/spoon{
	pixel_x = -2;
	pixel_y = 8
	},
/turf/open/floor/rogue/hexstone,
/area/rogue/indoors)
"zD" = (
/obj/structure/roguewindow,
/turf/open/floor/rogue/ruinedwood,
/area/rogue/indoors)
"Aa" = (
/obj/structure/fluff/railing/corner/south_west,
/turf/open/floor/rogue/hexstone,
/area/rogue/indoors)
"Ae" = (
/obj/structure/fluff/railing/border,
/turf/open/floor/rogue/grass,
/area/rogue/outdoors/mountains)
"Aw" = (
/obj/structure/closet/crate/roguecloset,
/turf/open/floor/rogue/ruinedwood,
/area/rogue)
"AZ" = (
/turf/open/floor/rogue/dirt/road,
/area/rogue/outdoors/mountains)
"Br" = (
/obj/machinery/light/rogue/chand,
/turf/open/transparent/openspace,
/area/rogue)
"CZ" = (
/obj/item/bedsheet/rogue/double_pelt,
/obj/structure/bed/rogue/inn/wooldouble,
/turf/open/floor/rogue/ruinedwood,
/area/rogue)
"Eu" = (
/turf/closed/wall/mineral/rogue/decowood,
/area/rogue)
"EF" = (
/obj/structure/chair/stool/rogue,
/turf/open/floor/rogue/ruinedwood,
/area/rogue/indoors)
"Fa" = (
/obj/structure/fluff/railing/border,
/obj/structure/table/wood,
/obj/item/reagent_containers/glass/bowl,
/obj/item/reagent_containers/glass/bowl,
/obj/item/reagent_containers/glass/bowl,
/turf/open/floor/rogue/hexstone,
/area/rogue/indoors)
"GB" = (
/turf/closed/wall/mineral/rogue/wooddark,
/area/rogue/outdoors/mountains)
"GG" = (
/turf/open/floor/rogue/grass,
/area/rogue/outdoors/mountains)
"GS" = (
/obj/structure/fluff/railing/corner/south_west,
/turf/open/floor/rogue/ruinedwood,
/area/rogue/indoors)
"Hl" = (
/turf/open/floor/rogue/twig,
/area/rogue/outdoors/mountains)
"Ii" = (
/obj/structure/stairs{
	dir = 1
	},
/turf/open/floor/rogue/dirt/road,
/area/rogue/outdoors/mountains)
"Iw" = (
/obj/item/bedsheet/rogue/pelt,
/obj/structure/bed/rogue/inn/wool,
/turf/open/floor/rogue/ruinedwood,
/area/rogue)
"Iz" = (
/obj/structure/fluff/railing/corner/south_west,
/turf/open/floor/rogue/dirt/road,
/area/rogue/outdoors/mountains)
"IP" = (
/obj/structure/fluff/walldeco/innsign,
/turf/closed/wall/mineral/rogue/decowood,
/area/rogue/indoors)
"Jd" = (
/obj/structure/chair/wood/rogue/chair3,
/obj/effect/decal/cleanable/dirt/cobweb/cobweb2,
/turf/open/floor/rogue/ruinedwood,
/area/rogue/indoors)
"Jp" = (
/obj/structure/mineral_door/wood/deadbolt/shutter{
	dir = 8
	},
/obj/structure/table/wood/poor,
/turf/open/floor/rogue/ruinedwood,
/area/rogue/indoors)
"Ju" = (
/obj/structure/fluff/railing/border/north,
/turf/open/floor/rogue/grass,
/area/rogue/outdoors/mountains)
"Jy" = (
/obj/machinery/tanningrack,
/obj/effect/decal/cleanable/dirt/cobweb/cobweb2,
/turf/open/floor/rogue/hexstone,
/area/rogue/indoors)
"Kx" = (
/obj/structure/table/wood/poor,
/obj/structure/mineral_door/wood/deadbolt/shutter{
	dir = 8
	},
/turf/open/floor/rogue/ruinedwood,
/area/rogue/indoors)
"Lx" = (
/obj/structure/table/wood/poor,
/obj/item/trash/candle,
/turf/open/floor/rogue/ruinedwood,
/area/rogue)
"LK" = (
/obj/machinery/light/rogue/candle/l,
/turf/open/floor/rogue/ruinedwood,
/area/rogue)
"LL" = (
/obj/machinery/light/rogue/hearth,
/obj/item/cooking/pan,
/turf/open/floor/rogue/hexstone,
/area/rogue/indoors)
"LR" = (
/obj/effect/decal/remains/human,
/obj/structure/roguemachine/mail/r{
	mailtag = "Old Inn"
	},
/turf/open/floor/rogue/ruinedwood,
/area/rogue/indoors)
"LT" = (
/obj/structure/fluff/railing/border/west,
/turf/open/transparent/openspace,
/area/rogue)
"Md" = (
/turf/closed/wall/mineral/rogue/stone,
/area/rogue/indoors)
"My" = (
/turf/open/floor/carpet/red,
/area/rogue/indoors)
"MC" = (
/obj/machinery/light/rogue/candle/l,
/turf/open/floor/rogue/ruinedwood,
/area/rogue/indoors)
"No" = (
/obj/structure/fermentation_keg/random/water,
/turf/open/floor/rogue/ruinedwood,
/area/rogue/indoors)
"NW" = (
/obj/structure/fluff/railing/border,
/turf/open/transparent/openspace,
/area/rogue)
"Oz" = (
/obj/structure/table/wood/poor,
/turf/open/floor/rogue/ruinedwood,
/area/rogue/indoors)
"OH" = (
/mob/living/carbon/human/species/skeleton/npc/mediumspread,
/obj/machinery/light/rogue/campfire/fireplace{
	pixel_y = 32
	},
/turf/open/floor/rogue/ruinedwood,
/area/rogue)
"OX" = (
/obj/structure/fluff/railing/wood/east,
/turf/open/floor/rogue/twig,
/area/rogue/outdoors/mountains)
"Pb" = (
/obj/machinery/light/rogue/oven/south,
/turf/open/floor/rogue/hexstone,
/area/rogue/indoors)
"Pu" = (
/turf/open/floor/rogue/grassyel,
/area/rogue/outdoors/woods/south)
"Py" = (
/obj/structure/chair/wood/rogue{
	dir = 4
	},
/turf/open/floor/rogue/ruinedwood,
/area/rogue)
"PC" = (
/obj/machinery/light/rogue/campfire/fireplace{
	pixel_y = 32
	},
/turf/open/floor/rogue/ruinedwood,
/area/rogue)
"QE" = (
/obj/structure/chair/wood/rogue/chair3{
	dir = 1
	},
/turf/open/floor/rogue/ruinedwood,
/area/rogue)
"RA" = (
/obj/structure/mineral_door/wood/deadbolt{
	dir = 8
	},
/turf/open/floor/rogue/ruinedwood,
/area/rogue)
"RY" = (
/obj/structure/closet/crate/chest,
/obj/item/reagent_containers/powder/salt,
/obj/item/reagent_containers/powder/salt,
/obj/item/reagent_containers/powder/salt,
/turf/open/floor/rogue/hexstone,
/area/rogue/indoors)
"Th" = (
/turf/open/floor/rogue/rooftop/green/east,
/area/rogue)
"TR" = (
/obj/structure/mineral_door/swing_door,
/turf/open/floor/rogue/ruinedwood,
/area/rogue/indoors)
"Us" = (
/obj/structure/fluff/railing/border/west,
/turf/open/floor/rogue/dirt/road,
/area/rogue/outdoors/mountains)
"Vc" = (
/obj/structure/fluff/railing/border/north,
/obj/structure/table/wood,
/turf/open/floor/rogue/hexstone,
/area/rogue/indoors)
"YB" = (
/obj/structure/stairs{
	dir = 1
	},
/obj/structure/fluff/railing/border/west,
/turf/open/floor/rogue/dirt/road,
/area/rogue/outdoors/mountains)
"ZD" = (
/obj/structure/stairs{
	dir = 8
	},
/obj/structure/fluff/railing/border,
/turf/open/floor/rogue/ruinedwood,
/area/rogue/indoors)

(1,1,1) = {"
nD
nD
nD
nD
nD
nD
nD
nD
nD
nD
nD
nD
Pu
"}
(2,1,1) = {"
sl
sl
sl
sl
sl
sl
sl
sl
sl
sl
sl
sl
sl
"}
(3,1,1) = {"
sl
sl
sl
sl
sl
sl
sl
sl
sl
sl
sl
sl
sl
"}
(4,1,1) = {"
sl
sl
sl
sl
sl
sl
sl
sl
sl
sl
sl
sl
sl
"}
(5,1,1) = {"
sl
sl
sl
sl
sl
sl
sl
sl
sl
sl
sl
sl
sl
"}
(6,1,1) = {"
sl
sl
sl
sl
sl
sl
sl
sl
sl
sl
sl
sl
sl
"}
(7,1,1) = {"
sl
sl
sl
sl
sl
sl
sl
sl
sl
sl
sl
sl
sl
"}
(8,1,1) = {"
sl
sl
sl
sl
sl
sl
sl
sl
sl
sl
sl
sl
sl
"}
(9,1,1) = {"
sl
sl
sl
sl
sl
sl
sl
sl
sl
sl
sl
sl
sl
"}
(10,1,1) = {"
sl
sl
sl
sl
sl
sl
sl
sl
sl
sl
sl
sl
sl
"}
(11,1,1) = {"
sl
sl
sl
sl
sl
sl
sl
sl
sl
sl
sl
sl
sl
"}
(12,1,1) = {"
sl
sl
sl
sl
sl
sl
sl
sl
sl
sl
sl
sl
sl
"}
(13,1,1) = {"
sl
sl
sl
sl
sl
sl
sl
sl
sl
sl
sl
sl
sl
"}
(14,1,1) = {"
sl
sl
sl
sl
sl
sl
sl
sl
sl
sl
sl
sl
sl
"}
(15,1,1) = {"
sl
sl
sl
sl
sl
sl
sl
sl
sl
sl
sl
sl
sl
"}
(16,1,1) = {"
sl
sl
sl
sl
sl
sl
sl
sl
sl
sl
sl
sl
sl
"}
(17,1,1) = {"
sl
sl
sl
sl
sl
sl
sl
sl
sl
sl
sl
sl
sl
"}

(1,1,2) = {"
GG
GG
GG
GG
GG
GG
GG
GG
GG
GG
GG
GG
uL
"}
(2,1,2) = {"
GG
kr
Md
uu
uu
uu
Md
Md
Md
uu
Md
kr
GG
"}
(3,1,2) = {"
GG
Md
yF
Fa
LL
rG
Vc
nq
tU
RY
gl
Md
GG
"}
(4,1,2) = {"
GG
Md
Pb
Aa
xh
xh
ja
tT
xy
xy
xy
uu
GG
"}
(5,1,2) = {"
GG
Md
Jy
xy
xy
tT
xy
xy
xy
xy
pZ
uu
GG
"}
(6,1,2) = {"
GG
kr
kr
kr
yh
Jp
Kx
Jp
yh
kt
yh
kr
GG
"}
(7,1,2) = {"
GG
kr
kr
kr
wx
qS
tE
tE
MC
tE
pb
yh
GG
"}
(8,1,2) = {"
GG
kr
kr
kr
cy
tE
tE
tE
tE
tE
No
yh
GG
"}
(9,1,2) = {"
GG
yh
ZD
kr
Oz
Oz
Oz
ay
Oz
TR
yh
kr
GG
"}
(10,1,2) = {"
GG
yh
GS
rT
EF
ka
EF
EF
EF
tE
tE
yh
GG
"}
(11,1,2) = {"
GG
yh
tE
tE
tE
sg
tE
tE
tE
tE
LR
yh
GG
"}
(12,1,2) = {"
GG
yh
Jd
Oz
tt
My
My
kr
zD
zD
yh
kr
tK
"}
(13,1,2) = {"
GG
kr
kr
Oz
tt
My
My
yh
Hl
Hl
Hl
ub
Ju
"}
(14,1,2) = {"
GG
Ae
kr
zD
zD
IP
dp
IP
Hl
Hl
OX
GB
kg
"}
(15,1,2) = {"
GG
Ae
lo
Hl
Hl
Hl
Hl
Hl
Hl
Hl
YB
Us
rj
"}
(16,1,2) = {"
vW
bp
GB
OX
GB
OX
OX
OX
OX
OX
Ii
AZ
AZ
"}
(17,1,2) = {"
vW
Iz
Us
Us
gw
gw
gw
gw
gw
gw
rj
AZ
AZ
"}

(1,1,3) = {"
kC
kC
kC
kC
kC
kC
kC
kC
kC
kC
kC
kC
kC
"}
(2,1,3) = {"
kC
ac
Eu
vQ
ac
Eu
vQ
Eu
ac
vQ
Eu
ac
kC
"}
(3,1,3) = {"
kC
Eu
Aw
vm
Eu
ib
vm
Py
Eu
vm
Aw
Eu
kC
"}
(4,1,3) = {"
kC
Eu
PC
vm
Eu
OH
vm
Lx
Eu
PC
vm
Eu
kC
"}
(5,1,3) = {"
kC
Eu
eb
vm
Eu
CZ
vm
lt
Eu
vm
Iw
Eu
kC
"}
(6,1,3) = {"
kC
ac
Eu
RA
ac
Eu
RA
Eu
ac
RA
Eu
ac
kC
"}
(7,1,3) = {"
kC
Eu
vm
vm
LK
vm
vm
vm
LK
vm
vm
Eu
kC
"}
(8,1,3) = {"
kC
Eu
aI
vm
vm
vm
vm
vm
vm
vm
vm
Eu
kC
"}
(9,1,3) = {"
kC
Eu
NW
fT
pt
QE
vm
vm
fT
pt
QE
Eu
kC
"}
(10,1,3) = {"
kC
Eu
mX
LT
LT
LT
LT
LT
LT
LT
LT
Eu
kC
"}
(11,1,3) = {"
kC
Eu
kC
kC
kC
kC
kC
kC
kC
kC
kC
Eu
kC
"}
(12,1,3) = {"
kC
Eu
kC
kC
kC
Br
kC
ac
Eu
Eu
Eu
ac
kC
"}
(13,1,3) = {"
kC
ac
ac
kC
kC
kC
kC
Eu
Th
Th
Th
Th
kC
"}
(14,1,3) = {"
kC
kC
ac
vQ
vQ
ac
Eu
ac
Th
Th
Th
Th
kC
"}
(15,1,3) = {"
kC
kC
Th
Th
Th
kC
kC
kC
kC
kC
kC
kC
kC
"}
(16,1,3) = {"
kC
kC
Th
Th
Th
kC
kC
kC
kC
kC
kC
kC
kC
"}
(17,1,3) = {"
kC
kC
kC
kC
kC
kC
kC
kC
kC
kC
kC
kC
kC
"}
