//MAP CONVERTED BY dmm2tgm.py THIS HEADER COMMENT PREVENTS RECONVERSION, DO NOT REMOVE
"a" = (
/turf/closed/wall/mineral/rogue/wooddark/end,
/area/rogue/indoors)
"b" = (
/obj/structure/roguewindow,
/turf/open/floor/rogue/ruinedwood,
/area/rogue/indoors)
"c" = (
/obj/machinery/light/rogue/torchholder/l,
/turf/open/transparent/openspace,
/area/rogue/outdoors/mountains)
"e" = (
/turf/open/floor/rogue/rooftop/green/north,
/area/rogue/outdoors/mountains)
"g" = (
/obj/structure/stairs{
	dir = 1
	},
/obj/structure/fluff/railing/border{
	dir = 10;
	pixel_x = 32
	},
/turf/open/floor/rogue/ruinedwood,
/area/rogue/indoors)
"h" = (
/obj/structure/mineral_door/wood/deadbolt{
	dir = 1
	},
/turf/open/floor/rogue/ruinedwood,
/area/rogue/indoors)
"i" = (
/obj/structure/bed/rogue{
	dir = 1
	},
/obj/effect/landmark/quest_spawner/easy,
/turf/open/floor/rogue/ruinedwood,
/area/rogue/indoors)
"j" = (
/obj/structure/floordoor{
	redstone_id = "castle_sally_gate"
	},
/obj/structure/ladder{
	icon_state = "ladderwall";
	dir = 1;
	pixel_y = 20
	},
/turf/open/transparent/openspace,
/area/rogue/indoors)
"k" = (
/turf/open/floor/carpet/red,
/area/rogue/indoors)
"l" = (
/obj/structure/fluff/railing/border{
	dir = 6
	},
/obj/structure/ladder{
	icon_state = "ladderwall";
	dir = 1;
	pixel_y = 20
	},
/turf/open/floor/rogue/ruinedwood,
/area/rogue/indoors)
"m" = (
/obj/structure/fluff/railing/border{
	dir = 4
	},
/turf/open/floor/rogue/ruinedwood,
/area/rogue/indoors)
"p" = (
/obj/structure/fluff/railing/border{
	dir = 4
	},
/turf/closed/wall/mineral/rogue/wooddark,
/area/rogue/indoors)
"r" = (
/obj/machinery/light/rogue/campfire/fireplace,
/turf/open/floor/carpet/red,
/area/rogue/indoors)
"t" = (
/turf/closed/wall/mineral/rogue/wooddark,
/area/rogue/indoors)
"u" = (
/obj/structure/fluff/railing/border{
	dir = 8;
	pixel_x = 32
	},
/turf/open/transparent/openspace,
/area/rogue/indoors)
"x" = (
/obj/structure/fluff/railing/border{
	dir = 6;
	pixel_y = -6
	},
/turf/open/floor/rogue/ruinedwood,
/area/rogue/indoors)
"y" = (
/turf/closed/wall/mineral/rogue/wooddark,
/area/rogue/outdoors/mountains)
"A" = (
/turf/closed/wall/mineral/rogue/wooddark/end/north,
/area/rogue/indoors)
"B" = (
/obj/structure/closet/crate/chest/loot_chest/locked,
/turf/open/floor/rogue/ruinedwood,
/area/rogue/indoors)
"H" = (
/obj/item/candle/skull/lit,
/obj/structure/table/wood/poor,
/obj/structure/fluff/railing/border{
	dir = 5;
	pixel_x = -32;
	pixel_y = -32
	},
/obj/structure/fluff/railing/border{
	pixel_y = -32;
	dir = 1
	},
/obj/structure/fluff/railing/border{
	dir = 9;
	pixel_x = 32;
	pixel_y = -32
	},
/obj/structure/fluff/railing/border{
	dir = 8;
	pixel_x = 32
	},
/turf/open/floor/rogue/ruinedwood,
/area/rogue/indoors)
"I" = (
/obj/structure/fluff/railing/border{
	dir = 8;
	pixel_x = 32
	},
/obj/structure/fluff/railing/border{
	pixel_y = -32;
	dir = 1
	},
/obj/structure/fluff/railing/border{
	dir = 9;
	pixel_x = 32;
	pixel_y = -32
	},
/obj/structure/fluff/railing/border{
	dir = 5;
	pixel_x = -32;
	pixel_y = -32
	},
/obj/structure/fluff/railing/border{
	dir = 9;
	pixel_x = 32;
	pixel_y = -32
	},
/turf/open/transparent/openspace,
/area/rogue/indoors)
"J" = (
/turf/open/transparent/openspace,
/area/rogue/outdoors/mountains)
"L" = (
/turf/closed/wall/mineral/rogue/wooddark/end/west,
/area/rogue/indoors)
"N" = (
/turf/open/floor/rogue/dirt/road,
/area/rogue/indoors/shelter/woods)
"O" = (
/turf/closed/wall/mineral/rogue/decowood,
/area/rogue/indoors)
"R" = (
/obj/structure/chair/wood/rogue{
	dir = 8
	},
/obj/structure/fluff/walldeco/sign/trophy,
/turf/open/floor/carpet/red,
/area/rogue/indoors)
"T" = (
/turf/closed/wall/mineral/rogue/wooddark,
/area/rogue/indoors/shelter/woods)
"V" = (
/obj/structure/fluff/railing/border{
	dir = 10;
	pixel_x = 32
	},
/obj/structure/stairs{
	dir = 1;
	pixel_y = -7
	},
/turf/open/floor/rogue/ruinedwood,
/area/rogue/indoors)
"X" = (
/turf/open/floor/rogue/ruinedwood,
/area/rogue/indoors)

(1,1,1) = {"
t
O
O
A
T
"}
(2,1,1) = {"
O
k
X
h
N
"}
(3,1,1) = {"
O
r
k
L
N
"}
(4,1,1) = {"
O
R
x
p
a
"}
(5,1,1) = {"
O
t
g
H
O
"}
(6,1,1) = {"
t
O
O
O
t
"}

(1,1,2) = {"
t
O
O
A
y
"}
(2,1,2) = {"
O
i
X
b
c
"}
(3,1,2) = {"
b
X
X
L
J
"}
(4,1,2) = {"
O
l
m
p
a
"}
(5,1,2) = {"
O
V
u
I
O
"}
(6,1,2) = {"
t
O
b
O
t
"}

(1,1,3) = {"
e
e
e
e
e
"}
(2,1,3) = {"
e
e
e
e
e
"}
(3,1,3) = {"
t
b
b
L
e
"}
(4,1,3) = {"
O
j
X
t
a
"}
(5,1,3) = {"
O
X
X
B
O
"}
(6,1,3) = {"
t
O
O
O
t
"}
