//MAP CONVERTED BY dmm2tgm.py THIS HEADER COMMENT PREVENTS RECONVERSION, DO NOT REMOVE
"a" = (
/turf/closed/wall/mineral/rogue/decowood,
/area/rogue/indoors/shelter/woods)
"g" = (
/turf/open/floor/rogue/ruinedwood,
/area/rogue/indoors/shelter/woods)
"h" = (
/obj/item/grown/log/tree/small,
/turf/open/floor/rogue/dirt,
/area/rogue/indoors/shelter/woods)
"p" = (
/turf/open/floor/rogue/dirt,
/area/rogue/outdoors/woods/south)
"t" = (
/turf/open/floor/rogue/rooftop/green/north,
/area/rogue/outdoors/town/roofs)
"x" = (
/obj/item/chair/stool/bar/rogue/crafted,
/turf/open/floor/rogue/ruinedwood,
/area/rogue/indoors/shelter/woods)
"I" = (
/obj/item/grown/log/tree/small,
/turf/open/floor/rogue/dirt/road,
/area/rogue/indoors/shelter/woods)
"J" = (
/turf/open/transparent/openspace,
/area/rogue/outdoors/mountains)
"L" = (
/obj/item/grown/log/tree/stick,
/turf/open/floor/rogue/dirt/road,
/area/rogue/indoors/shelter/woods)
"N" = (
/turf/open/floor/rogue/dirt/road,
/area/rogue/indoors/shelter/woods)
"O" = (
/turf/open/floor/rogue/dirt,
/area/rogue/indoors/shelter/woods)
"T" = (
/turf/closed/wall/mineral/rogue/wooddark,
/area/rogue/indoors/shelter/woods)

(1,1,1) = {"
T
I
a
T
p
"}
(2,1,1) = {"
I
g
L
h
O
"}
(3,1,1) = {"
O
g
N
L
N
"}
(4,1,1) = {"
a
g
x
g
a
"}
(5,1,1) = {"
a
g
g
g
a
"}
(6,1,1) = {"
T
a
a
a
T
"}

(1,1,2) = {"
t
t
t
t
J
"}
(2,1,2) = {"
t
t
t
t
J
"}
(3,1,2) = {"
t
t
t
t
t
"}
(4,1,2) = {"
t
t
t
t
t
"}
(5,1,2) = {"
t
t
t
t
t
"}
(6,1,2) = {"
t
t
t
t
t
"}

(1,1,3) = {"
J
J
J
J
J
"}
(2,1,3) = {"
J
J
J
J
J
"}
(3,1,3) = {"
J
J
J
J
J
"}
(4,1,3) = {"
J
J
J
J
J
"}
(5,1,3) = {"
J
J
J
J
J
"}
(6,1,3) = {"
J
J
J
J
J
"}
