//MAP CONVERTED BY dmm2tgm.py THIS HEADER COMMENT PREVENTS RECONVERSION, DO NOT REMOVE
"ak" = (
/obj/structure/stairs{
	dir = 1
	},
/obj/structure/fluff/railing/border/west,
/turf/open/floor/rogue/dirt/road,
/area/rogue/outdoors/woods/south)
"ar" = (
/obj/structure/fluff/railing/wood/north,
/turf/open/floor/rogue/twig,
/area/rogue/outdoors/woods/south)
"az" = (
/obj/structure/spider/stickyweb,
/obj/effect/spawner/lootdrop/roguetown/sewers,
/turf/open/floor/rogue/naturalstone,
/area/rogue/under/cavewet/bogcaves/north)
"aJ" = (
/turf/open/floor/carpet/red,
/area/rogue/indoors)
"aL" = (
/obj/structure/table/wood/poor,
/obj/item/trash/candle,
/turf/open/floor/rogue/ruinedwood,
/area/rogue/indoors)
"br" = (
/turf/open/floor/rogue/hexstone,
/area/rogue/indoors)
"bz" = (
/obj/machinery/light/rogue/oven/south,
/turf/open/floor/rogue/hexstone,
/area/rogue/indoors)
"dp" = (
/obj/structure/fluff/railing/border,
/turf/open/floor/rogue/grass,
/area/rogue/outdoors/woods/south)
"eh" = (
/turf/closed/mineral/random/rogue/high,
/area/rogue/under/cavewet/bogcaves/north)
"eE" = (
/obj/structure/chair/wood/rogue{
	dir = 4
	},
/turf/open/floor/rogue/ruinedwood,
/area/rogue/indoors)
"fr" = (
/obj/structure/fluff/railing/corner/south_west,
/turf/open/floor/rogue/hexstone,
/area/rogue/indoors)
"fu" = (
/obj/structure/fluff/railing/corner/north_east,
/turf/open/floor/rogue/grass,
/area/rogue/outdoors/woods/south)
"fw" = (
/obj/structure/chair/stool/rogue,
/obj/effect/landmark/start/courtagent,
/turf/open/floor/rogue/ruinedwood,
/area/rogue/indoors)
"gq" = (
/obj/structure/fluff/railing/corner/south_west,
/turf/open/floor/rogue/dirt/road,
/area/rogue/outdoors/woods/south)
"gv" = (
/obj/structure/mineral_door/wood/window,
/turf/open/floor/rogue/ruinedwood,
/area/rogue/indoors)
"gN" = (
/obj/structure/chair/wood/rogue/chair3,
/obj/effect/decal/cleanable/dirt/cobweb/cobweb2,
/turf/open/floor/rogue/ruinedwood,
/area/rogue/indoors)
"gY" = (
/turf/open/floor/rogue/dirt/road,
/area/rogue/outdoors/woods/south)
"hp" = (
/turf/open/floor/rogue/rooftop/green/north,
/area/rogue/outdoors/town/roofs)
"iX" = (
/obj/structure/fermentation_keg/random/beer,
/turf/open/floor/rogue/ruinedwood,
/area/rogue/indoors)
"jd" = (
/obj/structure/fluff/railing/corner,
/turf/open/floor/rogue/dirt/road,
/area/rogue/outdoors/woods/south)
"kj" = (
/turf/open/floor/rogue/naturalstone,
/area/rogue/under/cavewet/bogcaves/north)
"kJ" = (
/obj/machinery/light/rogue/hearth,
/obj/item/cooking/pan,
/turf/open/floor/rogue/hexstone,
/area/rogue/indoors)
"kM" = (
/obj/structure/closet/crate/chest,
/obj/item/reagent_containers/food/snacks/rogue/meat/steak,
/obj/item/reagent_containers/food/snacks/rogue/meat/steak,
/obj/item/reagent_containers/food/snacks/rogue/meat/steak,
/turf/open/floor/rogue/hexstone,
/area/rogue/indoors)
"mt" = (
/turf/closed/mineral/random/rogue/med,
/area/rogue/under/cavewet/bogcaves/north)
"mF" = (
/obj/structure/fluff/railing/border/west,
/turf/open/floor/rogue/hexstone,
/area/rogue/indoors)
"mY" = (
/obj/item/bedsheet/rogue/pelt,
/obj/structure/bed/rogue/inn/wool,
/turf/open/floor/rogue/ruinedwood,
/area/rogue/indoors)
"nu" = (
/turf/closed/wall/mineral/rogue/stone/moss,
/area/rogue/indoors)
"oh" = (
/obj/structure/chair/wood/rogue/chair3{
	dir = 1
	},
/turf/open/floor/rogue/ruinedwood,
/area/rogue/indoors)
"op" = (
/obj/machinery/light/rogue/candle/l,
/turf/open/floor/rogue/ruinedwood,
/area/rogue/indoors)
"oF" = (
/obj/structure/rack/rogue,
/obj/item/reagent_containers/glass/cup/wooden,
/obj/item/reagent_containers/glass/cup/wooden,
/turf/open/floor/rogue/ruinedwood,
/area/rogue/indoors)
"oK" = (
/obj/machinery/tanningrack,
/obj/effect/decal/cleanable/dirt/cobweb/cobweb2,
/turf/open/floor/rogue/hexstone,
/area/rogue/indoors)
"pR" = (
/obj/structure/fluff/walldeco/innsign,
/turf/closed/wall/mineral/rogue/decowood,
/area/rogue/indoors)
"qj" = (
/turf/closed/wall/mineral/rogue/wooddark,
/area/rogue/indoors)
"qo" = (
/obj/structure/closet/crate/chest,
/obj/item/reagent_containers/powder/salt,
/obj/item/reagent_containers/powder/salt,
/obj/item/reagent_containers/powder/salt,
/turf/open/floor/rogue/hexstone,
/area/rogue/indoors)
"qF" = (
/obj/effect/decal/cleanable/dirt/cobweb,
/obj/structure/rack/rogue,
/obj/item/reagent_containers/glass/cup/wooden,
/obj/item/reagent_containers/glass/cup/wooden,
/obj/item/reagent_containers/glass/cup/wooden,
/obj/machinery/light/rogue/candle/l,
/turf/open/floor/rogue/ruinedwood,
/area/rogue/indoors)
"qW" = (
/turf/open/floor/rogue/grass,
/area/rogue/outdoors/woods/south)
"sI" = (
/turf/open/floor/rogue/dirt,
/area/rogue/under/cavewet/bogcaves/north)
"sK" = (
/obj/structure/stairs{
	dir = 1
	},
/turf/open/floor/rogue/dirt/road,
/area/rogue/outdoors/woods/south)
"uL" = (
/obj/structure/fluff/railing/border/north,
/turf/open/floor/rogue/grass,
/area/rogue/outdoors/woods/south)
"uW" = (
/obj/structure/fluff/railing/border/north,
/turf/open/floor/rogue/dirt/road,
/area/rogue/outdoors/woods/south)
"vx" = (
/obj/structure/chair/wood/rogue/chair3,
/turf/open/floor/rogue/ruinedwood,
/area/rogue/indoors)
"vT" = (
/turf/open/transparent/openspace,
/area/rogue/indoors)
"wW" = (
/obj/structure/fermentation_keg/random/water,
/turf/open/floor/rogue/ruinedwood,
/area/rogue/indoors)
"xp" = (
/turf/open/floor/rogue/rooftop/green/east,
/area/rogue/outdoors/mountains)
"xZ" = (
/obj/structure/table/wood,
/obj/item/cooking/platter,
/obj/item/kitchen/spoon{
	pixel_x = -2;
	pixel_y = 8
	},
/turf/open/floor/rogue/hexstone,
/area/rogue/indoors)
"zf" = (
/obj/structure/fluff/railing/corner/south_west,
/turf/open/floor/rogue/ruinedwood,
/area/rogue/indoors)
"zm" = (
/turf/closed/wall/mineral/rogue/stone,
/area/rogue/under/cave/skeletoncrypt)
"Am" = (
/obj/structure/closet/crate/roguecloset,
/obj/effect/spawner/lootdrop/cheap_jewelry_spawner,
/turf/open/floor/rogue/ruinedwood,
/area/rogue/indoors)
"AF" = (
/turf/closed/wall/mineral/rogue/wooddark,
/area/rogue/outdoors/woods/south)
"AH" = (
/obj/item/bedsheet/rogue/double_pelt,
/obj/structure/bed/rogue/inn/wooldouble,
/turf/open/floor/rogue/ruinedwood,
/area/rogue/indoors)
"BW" = (
/obj/structure/table/wood/poor,
/obj/structure/mineral_door/wood/deadbolt/shutter{
	dir = 8
	},
/turf/open/floor/rogue/ruinedwood,
/area/rogue/indoors)
"Ca" = (
/obj/machinery/light/rogue/campfire/fireplace{
	pixel_y = 32
	},
/turf/open/floor/rogue/ruinedwood,
/area/rogue/indoors)
"Cm" = (
/turf/closed/wall/mineral/rogue/stone,
/area/rogue/indoors)
"Cz" = (
/turf/closed/wall/mineral/rogue/decowood,
/area/rogue/indoors)
"CH" = (
/obj/structure/mineral_door/wood/deadbolt{
	dir = 8
	},
/turf/open/floor/rogue/ruinedwood,
/area/rogue/indoors)
"Da" = (
/obj/structure/spider/stickyweb,
/turf/open/floor/rogue/naturalstone,
/area/rogue/under/cavewet/bogcaves/north)
"DH" = (
/turf/open/transparent/openspace,
/area/rogue/outdoors/mountains)
"DY" = (
/mob/living/carbon/human/species/skeleton/npc/mediumspread,
/obj/machinery/light/rogue/campfire/fireplace{
	pixel_y = 32
	},
/turf/open/floor/rogue/ruinedwood,
/area/rogue/indoors)
"El" = (
/obj/structure/table/wood,
/obj/item/rogueweapon/huntingknife/stoneknife,
/turf/open/floor/rogue/hexstone,
/area/rogue/indoors)
"Ew" = (
/obj/structure/fluff/railing/border,
/obj/structure/table/wood,
/obj/item/reagent_containers/glass/bowl,
/obj/item/reagent_containers/glass/bowl,
/obj/item/reagent_containers/glass/bowl,
/turf/open/floor/rogue/hexstone,
/area/rogue/indoors)
"Fn" = (
/obj/structure/roguewindow,
/turf/open/floor/rogue/ruinedwood,
/area/rogue/indoors)
"Gu" = (
/obj/machinery/light/rogue/hearth,
/obj/item/reagent_containers/glass/bucket/pot,
/turf/open/floor/rogue/hexstone,
/area/rogue/indoors)
"Hz" = (
/obj/structure/fluff/railing/border/west,
/turf/open/floor/rogue/dirt/road,
/area/rogue/outdoors/woods/south)
"Iz" = (
/obj/structure/table/wood/poor,
/obj/item/reagent_containers/glass/cup/wooden,
/turf/open/floor/rogue/ruinedwood,
/area/rogue/indoors)
"Jl" = (
/obj/structure/mineral_door/swing_door,
/turf/open/floor/rogue/ruinedwood,
/area/rogue/indoors)
"JD" = (
/obj/structure/bed/rogue/inn/wool,
/obj/item/bedsheet/rogue/pelt,
/turf/open/floor/rogue/ruinedwood,
/area/rogue/indoors)
"JV" = (
/obj/structure/fluff/railing/border/west,
/turf/open/transparent/openspace,
/area/rogue/indoors)
"Kc" = (
/obj/structure/fluff/railing/corner,
/turf/open/floor/rogue/hexstone,
/area/rogue/indoors)
"Kn" = (
/obj/structure/fluff/railing/border/north,
/obj/structure/table/wood,
/turf/open/floor/rogue/hexstone,
/area/rogue/indoors)
"KF" = (
/obj/structure/fluff/railing/corner,
/turf/open/floor/rogue/ruinedwood,
/area/rogue/indoors)
"KO" = (
/obj/structure/closet/crate/roguecloset,
/turf/open/floor/rogue/ruinedwood,
/area/rogue/indoors)
"Lc" = (
/obj/structure/fluff/railing/border,
/turf/open/transparent/openspace,
/area/rogue/indoors)
"Lt" = (
/obj/structure/chair/stool/rogue,
/turf/open/floor/rogue/ruinedwood,
/area/rogue/indoors)
"LP" = (
/obj/structure/chair/wood/rogue{
	dir = 8
	},
/turf/open/floor/rogue/ruinedwood,
/area/rogue/indoors)
"Mj" = (
/mob/living/simple_animal/hostile/retaliate/rogue/bigrat,
/turf/open/floor/rogue/naturalstone,
/area/rogue/under/cavewet/bogcaves/north)
"MS" = (
/obj/item/millstone{
	pixel_y = 12
	},
/obj/structure/table/wood,
/turf/open/floor/rogue/hexstone,
/area/rogue/indoors)
"Nl" = (
/obj/structure/mineral_door/wood/deadbolt/shutter{
	dir = 8
	},
/obj/structure/table/wood/poor,
/turf/open/floor/rogue/ruinedwood,
/area/rogue/indoors)
"NP" = (
/obj/structure/mineral_door/wood,
/turf/open/floor/rogue/ruinedwood,
/area/rogue/indoors)
"PO" = (
/obj/effect/decal/remains/human,
/obj/structure/roguemachine/mail/r{
	mailtag = "Old Inn"
	},
/turf/open/floor/rogue/ruinedwood,
/area/rogue/indoors)
"QX" = (
/obj/machinery/tanningrack,
/turf/open/floor/rogue/hexstone,
/area/rogue/indoors)
"SE" = (
/obj/structure/fluff/railing/wood,
/turf/open/floor/rogue/twig,
/area/rogue/outdoors/woods/south)
"Tg" = (
/obj/structure/stairs{
	dir = 8
	},
/obj/structure/fluff/railing/border,
/turf/open/floor/rogue/ruinedwood,
/area/rogue/indoors)
"TA" = (
/turf/open/floor/rogue/grassyel,
/area/rogue/outdoors/woods/south)
"TL" = (
/obj/effect/decal/remains/human,
/turf/open/floor/rogue/ruinedwood,
/area/rogue/indoors)
"UW" = (
/obj/structure/fluff/railing/wood/east,
/turf/open/floor/rogue/twig,
/area/rogue/outdoors/woods/south)
"Vh" = (
/obj/machinery/light/rogue/chand,
/turf/open/transparent/openspace,
/area/rogue/indoors)
"Vi" = (
/turf/open/floor/rogue/dirt,
/area/rogue/outdoors/woods/south)
"VQ" = (
/mob/living/carbon/human/species/skeleton/npc/mediumspread,
/turf/open/floor/rogue/hexstone,
/area/rogue/indoors)
"VS" = (
/turf/open/floor/rogue/ruinedwood,
/area/rogue/indoors)
"Wc" = (
/obj/structure/table/wood/poor,
/turf/open/floor/rogue/ruinedwood,
/area/rogue/indoors)
"Wl" = (
/obj/structure/fluff/railing/corner/south_west,
/turf/open/transparent/openspace,
/area/rogue/indoors)
"Wq" = (
/turf/open/floor/rogue/twig,
/area/rogue/outdoors/woods/south)
"Yd" = (
/obj/structure/fluff/railing/border,
/turf/open/floor/rogue/dirt,
/area/rogue/outdoors/woods/south)
"Yp" = (
/obj/effect/decal/cleanable/blood,
/turf/open/floor/rogue/ruinedwood,
/area/rogue/indoors)
"ZZ" = (
/obj/structure/fluff/railing/border/west,
/turf/open/floor/rogue/dirt,
/area/rogue/outdoors/woods/south)

(1,1,1) = {"
kj
Da
kj
sI
sI
mt
mt
sI
mt
eh
eh
eh
eh
"}
(2,1,1) = {"
eh
mt
kj
Da
mt
mt
Da
kj
mt
eh
eh
eh
eh
"}
(3,1,1) = {"
eh
mt
Da
kj
Mj
kj
kj
kj
kj
sI
sI
eh
eh
"}
(4,1,1) = {"
eh
eh
eh
eh
mt
az
kj
kj
kj
sI
sI
sI
eh
"}
(5,1,1) = {"
eh
eh
eh
eh
eh
eh
eh
eh
eh
eh
sI
sI
eh
"}
(6,1,1) = {"
eh
eh
eh
eh
eh
eh
eh
eh
sI
sI
sI
sI
sI
"}
(7,1,1) = {"
eh
eh
eh
eh
eh
eh
eh
eh
eh
sI
sI
sI
sI
"}
(8,1,1) = {"
eh
eh
eh
eh
eh
eh
eh
eh
eh
eh
sI
sI
sI
"}
(9,1,1) = {"
eh
eh
eh
eh
eh
eh
eh
eh
eh
sI
sI
sI
sI
"}
(10,1,1) = {"
eh
eh
eh
eh
eh
eh
eh
eh
sI
sI
sI
sI
sI
"}
(11,1,1) = {"
eh
eh
eh
eh
eh
eh
eh
sI
sI
sI
sI
sI
sI
"}
(12,1,1) = {"
eh
eh
eh
eh
eh
eh
eh
sI
sI
sI
eh
eh
eh
"}
(13,1,1) = {"
eh
eh
eh
eh
eh
eh
sI
sI
sI
mt
mt
mt
mt
"}
(14,1,1) = {"
kj
eh
eh
eh
sI
sI
sI
sI
eh
mt
mt
mt
mt
"}
(15,1,1) = {"
kj
kj
kj
kj
sI
sI
sI
sI
eh
mt
mt
mt
mt
"}
(16,1,1) = {"
kj
kj
kj
kj
sI
sI
sI
eh
eh
mt
mt
mt
mt
"}
(17,1,1) = {"
kj
eh
eh
eh
sI
sI
sI
eh
eh
zm
zm
zm
zm
"}

(1,1,2) = {"
qW
qW
qW
qW
qW
qW
qW
qW
qW
qW
qW
qW
TA
"}
(2,1,2) = {"
qW
qj
Cm
nu
nu
nu
Cm
Cm
Cm
nu
Cm
qj
qW
"}
(3,1,2) = {"
qW
Cm
xZ
Ew
kJ
Gu
Kn
El
MS
qo
kM
Cm
qW
"}
(4,1,2) = {"
qW
Cm
bz
fr
mF
mF
Kc
VQ
br
br
br
nu
qW
"}
(5,1,2) = {"
qW
Cm
oK
br
br
VQ
br
br
br
br
QX
nu
qW
"}
(6,1,2) = {"
qW
qj
qj
qj
Cz
Nl
BW
Nl
Cz
NP
Cz
qj
qW
"}
(7,1,2) = {"
qW
qj
qj
qj
qF
TL
VS
VS
op
VS
oF
Cz
qW
"}
(8,1,2) = {"
qW
qj
qj
qj
iX
VS
VS
VS
VS
VS
wW
Cz
qW
"}
(9,1,2) = {"
qW
Cz
Tg
qj
Wc
Wc
Wc
Iz
Wc
Jl
Cz
qj
qW
"}
(10,1,2) = {"
qW
Cz
zf
KF
Lt
fw
Lt
Lt
Lt
VS
VS
Cz
qW
"}
(11,1,2) = {"
qW
Cz
VS
VS
VS
Yp
VS
VS
VS
VS
PO
Cz
qW
"}
(12,1,2) = {"
qW
Cz
gN
Wc
oh
aJ
aJ
qj
Fn
Fn
Cz
qj
fu
"}
(13,1,2) = {"
qW
qj
qj
Wc
oh
aJ
aJ
Cz
Wq
Wq
Wq
SE
uL
"}
(14,1,2) = {"
qW
dp
qj
Fn
Fn
pR
gv
pR
Wq
Wq
UW
AF
uW
"}
(15,1,2) = {"
qW
dp
ar
Wq
Wq
Wq
Wq
Wq
Wq
Wq
ak
Hz
jd
"}
(16,1,2) = {"
Vi
Yd
AF
UW
AF
UW
UW
UW
UW
UW
sK
gY
gY
"}
(17,1,2) = {"
Vi
gq
Hz
Hz
ZZ
ZZ
ZZ
ZZ
ZZ
ZZ
jd
gY
gY
"}

(1,1,3) = {"
DH
DH
DH
DH
DH
DH
DH
DH
DH
DH
DH
DH
DH
"}
(2,1,3) = {"
DH
qj
Cz
Fn
qj
Cz
Fn
Cz
qj
Fn
Cz
qj
DH
"}
(3,1,3) = {"
DH
Cz
KO
VS
Cz
Am
VS
eE
Cz
VS
KO
Cz
DH
"}
(4,1,3) = {"
DH
Cz
Ca
VS
Cz
DY
VS
aL
Cz
Ca
VS
Cz
DH
"}
(5,1,3) = {"
DH
Cz
JD
VS
Cz
AH
VS
LP
Cz
VS
mY
Cz
DH
"}
(6,1,3) = {"
DH
qj
Cz
CH
qj
Cz
CH
Cz
qj
CH
Cz
qj
DH
"}
(7,1,3) = {"
DH
Cz
VS
VS
op
VS
VS
VS
op
VS
VS
Cz
DH
"}
(8,1,3) = {"
DH
Cz
Tg
VS
VS
VS
VS
VS
VS
VS
VS
Cz
DH
"}
(9,1,3) = {"
DH
Cz
Lc
vx
Wc
oh
VS
VS
vx
Wc
oh
Cz
DH
"}
(10,1,3) = {"
DH
Cz
Wl
JV
JV
JV
JV
JV
JV
JV
JV
Cz
DH
"}
(11,1,3) = {"
DH
Cz
vT
vT
vT
vT
vT
vT
vT
vT
vT
Cz
DH
"}
(12,1,3) = {"
DH
Cz
vT
vT
vT
Vh
vT
qj
Cz
Cz
Cz
qj
DH
"}
(13,1,3) = {"
DH
qj
qj
vT
vT
vT
vT
Cz
xp
xp
xp
xp
DH
"}
(14,1,3) = {"
DH
DH
qj
Fn
Fn
qj
Cz
qj
xp
xp
xp
xp
DH
"}
(15,1,3) = {"
DH
DH
xp
xp
xp
DH
DH
DH
DH
DH
DH
DH
DH
"}
(16,1,3) = {"
DH
DH
xp
xp
xp
DH
DH
DH
DH
DH
DH
DH
DH
"}
(17,1,3) = {"
DH
DH
DH
DH
DH
DH
DH
DH
DH
DH
DH
DH
DH
"}

(1,1,4) = {"
DH
DH
DH
DH
DH
DH
DH
DH
DH
DH
DH
DH
DH
"}
(2,1,4) = {"
DH
hp
hp
hp
hp
hp
hp
hp
hp
hp
hp
hp
DH
"}
(3,1,4) = {"
DH
hp
hp
hp
hp
hp
hp
hp
hp
hp
hp
hp
DH
"}
(4,1,4) = {"
DH
hp
hp
hp
hp
hp
hp
hp
hp
hp
hp
hp
DH
"}
(5,1,4) = {"
DH
hp
hp
hp
hp
hp
hp
hp
hp
hp
hp
hp
DH
"}
(6,1,4) = {"
DH
hp
hp
hp
hp
hp
hp
hp
hp
hp
hp
hp
DH
"}
(7,1,4) = {"
DH
hp
hp
hp
hp
hp
hp
hp
hp
hp
hp
hp
DH
"}
(8,1,4) = {"
DH
hp
hp
hp
hp
hp
hp
hp
hp
hp
hp
hp
DH
"}
(9,1,4) = {"
DH
hp
hp
hp
hp
hp
hp
hp
hp
hp
hp
hp
DH
"}
(10,1,4) = {"
DH
hp
hp
hp
hp
hp
hp
hp
hp
hp
hp
hp
DH
"}
(11,1,4) = {"
DH
hp
hp
hp
hp
hp
hp
hp
hp
hp
hp
hp
DH
"}
(12,1,4) = {"
DH
hp
hp
hp
hp
hp
hp
hp
hp
hp
hp
hp
DH
"}
(13,1,4) = {"
DH
hp
hp
hp
hp
hp
hp
hp
DH
DH
DH
DH
DH
"}
(14,1,4) = {"
DH
DH
hp
hp
hp
hp
hp
hp
DH
DH
DH
DH
DH
"}
(15,1,4) = {"
DH
DH
DH
DH
DH
DH
DH
DH
DH
DH
DH
DH
DH
"}
(16,1,4) = {"
DH
DH
DH
DH
DH
DH
DH
DH
DH
DH
DH
DH
DH
"}
(17,1,4) = {"
DH
DH
DH
DH
DH
DH
DH
DH
DH
DH
DH
DH
DH
"}
