//MAP CONVERTED BY dmm2tgm.py THIS HEADER COMMENT PREVENTS RECONVERSION, DO NOT REMOVE
"a" = (
/obj/item/reagent_containers/food/snacks/crow{
	dir = 8
	},
/turf/open/floor/rogue/rooftop/green/north,
/area/rogue/outdoors/town/roofs)
"b" = (
/turf/open/floor/rogue/dirt,
/area/rogue/indoors/shelter/woods)
"c" = (
/turf/open/floor/rogue/dirt,
/area/rogue/outdoors/woods/south)
"d" = (
/obj/structure/roguewindow,
/turf/open/floor/rogue/ruinedwood/turned,
/area/rogue/indoors/shelter/woods)
"e" = (
/obj/structure/closet/crate/chest/wicker,
/turf/open/floor/rogue/ruinedwood,
/area/rogue/indoors/shelter/woods)
"f" = (
/obj/structure/fluff/railing/wood/west,
/turf/open/floor/rogue/twig,
/area/rogue/indoors/shelter/woods)
"g" = (
/turf/open/floor/rogue/ruinedwood,
/area/rogue/indoors/shelter/woods)
"h" = (
/obj/structure/bed/rogue/shit,
/turf/open/floor/rogue/twig,
/area/rogue/indoors/shelter/woods)
"i" = (
/turf/closed/wall/mineral/rogue/decowood,
/area/rogue/indoors/shelter/woods)
"j" = (
/turf/open/floor/rogue/naturalstone,
/area/rogue/under/cavewet/bogcaves/north)
"k" = (
/turf/open/floor/rogue/rooftop/green/north,
/area/rogue/outdoors/town/roofs)
"l" = (
/obj/structure/flora/newtree,
/turf/open/floor/rogue/grass,
/area/rogue/outdoors/woods/south)
"m" = (
/obj/structure/flora/newtree,
/turf/open/floor/rogue/dirt/road,
/area/rogue/indoors/shelter/woods)
"o" = (
/turf/closed/wall/mineral/rogue/wooddark,
/area/rogue/indoors/shelter/woods)
"p" = (
/turf/open/transparent/openspace,
/area/rogue/outdoors/mountains)
"q" = (
/obj/item/grown/log/tree/small,
/turf/open/floor/rogue/dirt/road,
/area/rogue/indoors/shelter/woods)
"s" = (
/obj/structure/table/wood/poor,
/turf/open/floor/rogue/dirt/road,
/area/rogue/indoors/shelter/woods)
"t" = (
/obj/item/grown/log/tree/stick,
/turf/open/floor/rogue/dirt,
/area/rogue/indoors/shelter/woods)
"u" = (
/turf/closed/wall/mineral/rogue/wooddark/vertical,
/area/rogue/indoors/shelter/woods)
"v" = (
/obj/item/grown/log/tree/stick,
/turf/open/floor/rogue/twig,
/area/rogue/indoors/shelter/woods)
"w" = (
/mob/living/simple_animal/hostile/rogue/deepone,
/turf/open/floor/rogue/naturalstone,
/area/rogue/under/cavewet/bogcaves/north)
"y" = (
/obj/structure/fluff/railing/wood/north{
	pixel_y = 1
	},
/obj/structure/fluff/railing/wood/east,
/turf/open/floor/rogue/twig,
/area/rogue/indoors/shelter/woods)
"z" = (
/turf/open/floor/rogue/dirt/road,
/area/rogue/indoors/shelter/woods)
"A" = (
/turf/closed/mineral/random/rogue/med,
/area/rogue/under/cavewet/bogcaves/north)
"B" = (
/obj/structure/roguewindow,
/turf/open/floor/rogue/twig,
/area/rogue/indoors/shelter/woods)
"C" = (
/turf/open/floor/rogue/twig,
/area/rogue/indoors/shelter/woods)
"D" = (
/obj/item/reagent_containers/food/snacks/crow,
/turf/open/floor/rogue/rooftop/green/north,
/area/rogue/outdoors/town/roofs)
"E" = (
/turf/open/floor/rogue/grass,
/area/rogue/outdoors/woods/south)
"F" = (
/obj/machinery/light/rogue/campfire,
/turf/open/floor/rogue/dirt,
/area/rogue/indoors/shelter/woods)
"G" = (
/obj/structure/mineral_door/wood/deadbolt{
	dir = 1;
	locked = 1
	},
/turf/open/floor/rogue/twig,
/area/rogue/indoors/shelter/woods)
"H" = (
/obj/item/chair/stool/bar/rogue/crafted,
/turf/open/floor/rogue/dirt/road,
/area/rogue/indoors/shelter/woods)
"I" = (
/mob/living/carbon/human/species/skeleton/npc/mediumspread,
/turf/open/floor/rogue/ruinedwood,
/area/rogue/indoors/shelter/woods)
"J" = (
/obj/structure/fluff/railing/wood/north{
	pixel_y = 1
	},
/turf/open/floor/rogue/twig,
/area/rogue/indoors/shelter/woods)
"K" = (
/obj/structure/closet/crate/chest/crate,
/obj/effect/spawner/lootdrop/roguetown/dungeon/weapons,
/turf/open/floor/rogue/naturalstone,
/area/rogue/under/cavewet/bogcaves/north)
"L" = (
/obj/structure/stairs{
	dir = 1
	},
/turf/open/floor/rogue/ruinedwood,
/area/rogue/indoors/shelter/woods)
"M" = (
/obj/structure/stairs{
	dir = 1
	},
/turf/open/floor/rogue/twig,
/area/rogue/indoors/shelter/woods)
"N" = (
/turf/open/transparent/openspace,
/area/rogue/indoors/shelter/woods)
"O" = (
/turf/open/floor/rogue/dirt/road,
/area/rogue/outdoors/woods/south)
"P" = (
/obj/structure/fluff/railing/wood/north{
	pixel_y = 1
	},
/obj/structure/fluff/railing/wood/west,
/turf/open/floor/rogue/twig,
/area/rogue/indoors/shelter/woods)
"Q" = (
/obj/item/reagent_containers/food/snacks/crow{
	dir = 1
	},
/turf/open/floor/rogue/rooftop/green/north,
/area/rogue/outdoors/town/roofs)
"R" = (
/obj/structure/fluff/railing/wood/east,
/turf/open/floor/rogue/twig,
/area/rogue/indoors/shelter/woods)
"S" = (
/turf/closed/wall/mineral/rogue/wooddark/end/north,
/area/rogue/indoors/shelter/woods)
"T" = (
/obj/structure/chair/stool/rogue,
/turf/open/floor/rogue/dirt,
/area/rogue/indoors/shelter/woods)
"U" = (
/turf/closed/mineral/random/rogue/high,
/area/rogue/under/cavewet/bogcaves/north)
"V" = (
/obj/structure/chair/stool/rogue,
/turf/open/floor/rogue/dirt/road,
/area/rogue/indoors/shelter/woods)
"W" = (
/obj/structure/roguewindow,
/turf/open/floor/rogue/grass,
/area/rogue/indoors/shelter/woods)
"X" = (
/obj/item/reagent_containers/food/snacks/crow{
	dir = 4
	},
/turf/open/floor/rogue/rooftop/green/north,
/area/rogue/outdoors/town/roofs)
"Y" = (
/turf/closed/mineral/random/rogue,
/area/rogue/under/cavewet/bogcaves/north)
"Z" = (
/turf/open/floor/rogue/ruinedwood/turned,
/area/rogue/indoors/shelter/woods)

(1,1,1) = {"
j
U
U
U
U
U
U
U
U
U
U
U
U
"}
(2,1,1) = {"
U
U
U
U
U
U
U
U
U
U
U
U
U
"}
(3,1,1) = {"
U
U
U
U
U
U
U
U
U
U
U
U
U
"}
(4,1,1) = {"
U
U
U
U
U
U
U
U
U
U
U
U
U
"}
(5,1,1) = {"
U
U
U
U
U
U
U
U
U
U
U
U
U
"}
(6,1,1) = {"
U
U
U
U
U
U
U
U
U
U
U
U
U
"}
(7,1,1) = {"
U
U
U
U
U
U
U
U
U
U
U
U
U
"}
(8,1,1) = {"
U
U
U
U
U
U
U
U
U
U
U
U
U
"}
(9,1,1) = {"
U
U
U
U
U
U
U
U
U
U
U
U
U
"}
(10,1,1) = {"
U
U
U
U
U
U
U
U
U
U
U
U
U
"}
(11,1,1) = {"
U
U
U
U
U
U
U
U
U
U
U
U
U
"}
(12,1,1) = {"
Y
A
A
A
A
A
A
Y
Y
Y
Y
Y
Y
"}
(13,1,1) = {"
Y
A
A
A
A
A
A
A
A
A
Y
Y
Y
"}
(14,1,1) = {"
Y
Y
Y
Y
Y
Y
Y
A
A
A
Y
Y
Y
"}
(15,1,1) = {"
j
Y
w
K
Y
Y
Y
A
A
A
A
A
Y
"}

(1,1,2) = {"
E
E
E
l
E
E
E
E
E
E
E
E
E
"}
(2,1,2) = {"
E
E
E
E
o
i
b
i
B
v
i
o
E
"}
(3,1,2) = {"
E
E
E
E
i
T
b
b
b
z
z
i
E
"}
(4,1,2) = {"
E
E
E
c
i
F
b
t
m
z
q
B
O
"}
(5,1,2) = {"
E
E
E
c
i
T
b
b
z
z
z
v
O
"}
(6,1,2) = {"
E
E
o
f
g
b
b
z
z
z
z
i
O
"}
(7,1,2) = {"
E
C
J
C
g
t
V
s
s
z
g
G
O
"}
(8,1,2) = {"
E
o
C
C
g
g
z
s
s
V
g
i
O
"}
(9,1,2) = {"
E
C
J
C
g
g
z
s
s
g
g
G
O
"}
(10,1,2) = {"
E
E
o
R
g
g
z
H
z
g
g
i
O
"}
(11,1,2) = {"
E
E
c
E
i
g
g
z
g
I
g
B
c
"}
(12,1,2) = {"
E
E
E
E
i
g
g
g
g
g
g
B
E
"}
(13,1,2) = {"
l
E
E
E
i
S
u
L
g
g
e
i
E
"}
(14,1,2) = {"
l
E
E
E
o
i
i
i
W
B
i
o
E
"}
(15,1,2) = {"
E
E
E
E
E
E
E
E
E
E
E
E
E
"}

(1,1,3) = {"
p
p
p
p
p
p
p
p
p
p
p
p
p
"}
(2,1,3) = {"
p
p
p
p
o
i
i
i
d
d
i
o
p
"}
(3,1,3) = {"
p
p
p
p
i
h
C
C
N
C
C
i
p
"}
(4,1,3) = {"
p
p
p
p
i
C
C
N
N
N
C
i
p
"}
(5,1,3) = {"
p
p
p
p
o
C
C
N
N
N
C
d
p
"}
(6,1,3) = {"
p
p
o
f
Z
C
N
N
N
N
C
d
p
"}
(7,1,3) = {"
p
P
C
C
Z
C
N
N
N
N
C
i
p
"}
(8,1,3) = {"
p
J
C
C
Z
C
N
N
N
N
C
i
p
"}
(9,1,3) = {"
p
y
C
C
Z
C
C
N
N
N
C
i
p
"}
(10,1,3) = {"
p
p
o
R
Z
C
N
N
N
N
C
d
p
"}
(11,1,3) = {"
p
p
p
p
o
C
C
N
N
N
C
d
p
"}
(12,1,3) = {"
p
p
p
p
i
C
C
C
C
C
C
i
p
"}
(13,1,3) = {"
p
p
p
p
i
C
M
N
N
C
h
i
p
"}
(14,1,3) = {"
p
p
p
p
o
i
i
i
d
d
i
o
p
"}
(15,1,3) = {"
p
p
p
p
p
p
p
p
p
p
p
p
p
"}

(1,1,4) = {"
p
p
p
p
p
p
p
p
p
p
p
p
p
"}
(2,1,4) = {"
p
p
p
p
k
k
k
k
k
k
k
k
p
"}
(3,1,4) = {"
p
p
p
p
k
k
k
k
k
k
k
k
p
"}
(4,1,4) = {"
p
p
p
p
k
k
k
k
k
k
k
k
p
"}
(5,1,4) = {"
p
p
p
p
k
k
X
X
k
X
k
k
p
"}
(6,1,4) = {"
p
p
k
k
k
D
k
k
k
k
k
k
p
"}
(7,1,4) = {"
p
k
k
k
k
k
k
k
X
k
Q
k
p
"}
(8,1,4) = {"
p
k
k
k
k
D
k
k
a
k
Q
k
p
"}
(9,1,4) = {"
p
k
k
k
k
k
k
k
k
k
k
k
p
"}
(10,1,4) = {"
p
p
k
k
k
D
k
k
a
a
k
k
p
"}
(11,1,4) = {"
p
p
p
p
k
k
k
k
k
k
k
k
p
"}
(12,1,4) = {"
p
p
p
p
k
k
k
k
k
k
k
k
p
"}
(13,1,4) = {"
p
p
p
p
k
k
k
k
k
k
k
k
p
"}
(14,1,4) = {"
p
p
p
p
k
k
k
k
k
k
k
k
p
"}
(15,1,4) = {"
p
p
p
p
p
p
p
p
p
p
p
p
p
"}
