//MAP CONVERTED BY dmm2tgm.py THIS HEADER COMMENT PREVENTS RECONVERSION, DO NOT REMOVE
"a" = (
/turf/open/floor/rogue/rooftop/green/north,
/area/rogue/outdoors/town/roofs)
"b" = (
/obj/structure/bed/rogue/shit,
/turf/open/floor/rogue/ruinedwood,
/area/rogue/indoors/shelter/woods)
"d" = (
/turf/open/floor/rogue/twig,
/area/rogue/indoors/shelter/woods)
"o" = (
/mob/living/carbon/human/species/skeleton/npc/mediumspread,
/turf/open/floor/rogue/dirt/road,
/area/rogue/indoors/shelter/woods)
"E" = (
/obj/structure/closet/crate/chest/wicker,
/obj/item/rogueweapon/hoe,
/turf/open/floor/rogue/ruinedwood,
/area/rogue/indoors/shelter/woods)
"F" = (
/obj/structure/roguetent,
/turf/open/floor/rogue/dirt/road,
/area/rogue/indoors/shelter/woods)
"H" = (
/obj/structure/roguewindow,
/turf/open/floor/rogue/twig,
/area/rogue/indoors/shelter/woods)
"J" = (
/turf/closed/wall/mineral/rogue/decowood,
/area/rogue/indoors/shelter/woods)
"P" = (
/turf/closed/wall/mineral/rogue/wooddark,
/area/rogue/indoors/shelter/woods)

(1,1,1) = {"
P
J
J
P
"}
(2,1,1) = {"
J
b
o
J
"}
(3,1,1) = {"
H
E
d
H
"}
(4,1,1) = {"
P
J
F
P
"}

(1,1,2) = {"
a
a
a
a
"}
(2,1,2) = {"
a
a
a
a
"}
(3,1,2) = {"
a
a
a
a
"}
(4,1,2) = {"
a
a
a
a
"}
