//MAP CONVERTED BY dmm2tgm.py THIS HEADER COMMENT PREVENTS RECONVERSION, DO NOT REMOVE
"a" = (
/turf/open/floor/rogue/rooftop/green/north,
/area/rogue/outdoors/town/roofs)
"b" = (
/obj/structure/rack/rogue/shelf,
/obj/structure/bed/rogue{
	dir = 8;
	pixel_y = 6
	},
/obj/item/reagent_containers/glass/bottle/rogue/water{
	pixel_y = 46;
	pixel_x = -6
	},
/turf/open/floor/rogue/ruinedwood,
/area/rogue/indoors/shelter/woods)
"d" = (
/turf/open/floor/rogue/ruinedwood,
/area/rogue/indoors/shelter/woods)
"o" = (
/mob/living/carbon/human/species/human/northern/militia/deserter,
/turf/open/floor/rogue/ruinedwood,
/area/rogue/indoors/shelter/woods)
"E" = (
/obj/structure/chair/stool/rogue{
	pixel_x = -8;
	pixel_y = -5
	},
/turf/open/floor/rogue/ruinedwood,
/area/rogue/indoors/shelter/woods)
"F" = (
/obj/structure/mineral_door/wood/deadbolt{
	dir = 8
	},
/turf/open/floor/rogue/ruinedwood,
/area/rogue/indoors/shelter/woods)
"H" = (
/obj/structure/bookcase/random{
	pixel_y = -12
	},
/turf/closed/wall/mineral/rogue/decowood,
/area/rogue/indoors/shelter/woods)
"J" = (
/turf/closed/wall/mineral/rogue/decowood,
/area/rogue/indoors/shelter/woods)
"O" = (
/obj/structure/roguewindow,
/turf/open/floor/rogue/ruinedwood,
/area/rogue/indoors/shelter/woods)
"P" = (
/turf/closed/wall/mineral/rogue/wooddark,
/area/rogue/indoors/shelter/woods)

(1,1,1) = {"
P
J
J
P
"}
(2,1,1) = {"
J
b
o
J
"}
(3,1,1) = {"
H
E
d
O
"}
(4,1,1) = {"
P
J
F
P
"}

(1,1,2) = {"
a
a
a
a
"}
(2,1,2) = {"
a
a
a
a
"}
(3,1,2) = {"
a
a
a
a
"}
(4,1,2) = {"
a
a
a
a
"}
