//MAP CONVERTED BY dmm2tgm.py THIS HEADER COMMENT PREVENTS RECONVERSION, DO NOT REMOVE
"a" = (
/turf/open/transparent/openspace,
/area/rogue/outdoors/mountains)
"b" = (
/turf/open/floor/rogue/grass,
/area/rogue/outdoors/woods/south)
"c" = (
/turf/open/floor/rogue/dirt/road,
/area/rogue/outdoors/woods/south)
"d" = (
/turf/open/floor/rogue/ruinedwood/turned,
/area/rogue/indoors/shelter/woods)
"e" = (
/obj/structure/bed/rogue/shit,
/turf/open/floor/rogue/twig,
/area/rogue/indoors/shelter/woods)
"f" = (
/obj/machinery/light/rogue/campfire,
/turf/open/floor/rogue/dirt,
/area/rogue/indoors/shelter/woods)
"g" = (
/obj/item/reagent_containers/food/snacks/crow{
	dir = 4
	},
/turf/open/floor/rogue/rooftop/green/north,
/area/rogue/outdoors/town/roofs)
"h" = (
/mob/living/carbon/human/species/skeleton/npc/mediumspread,
/turf/open/floor/rogue/ruinedwood,
/area/rogue/indoors/shelter/woods)
"k" = (
/obj/structure/roguewindow,
/turf/open/floor/rogue/grass,
/area/rogue/indoors/shelter/woods)
"l" = (
/obj/item/reagent_containers/food/snacks/crow{
	dir = 1
	},
/turf/open/floor/rogue/rooftop/green/north,
/area/rogue/outdoors/town/roofs)
"m" = (
/obj/item/grown/log/tree/stick,
/turf/open/floor/rogue/dirt,
/area/rogue/indoors/shelter/woods)
"n" = (
/obj/structure/roguewindow,
/turf/open/floor/rogue/twig,
/area/rogue/indoors/shelter/woods)
"o" = (
/obj/structure/mineral_door/wood/deadbolt{
	dir = 1;
	locked = 1
	},
/turf/open/floor/rogue/twig,
/area/rogue/indoors/shelter/woods)
"p" = (
/obj/structure/closet/crate/chest/wicker,
/turf/open/floor/rogue/ruinedwood,
/area/rogue/indoors/shelter/woods)
"r" = (
/turf/open/floor/rogue/dirt/road,
/area/rogue/indoors/shelter/woods)
"s" = (
/obj/structure/table/wood/poor,
/turf/open/floor/rogue/dirt/road,
/area/rogue/indoors/shelter/woods)
"t" = (
/turf/open/floor/rogue/dirt,
/area/rogue/indoors/shelter/woods)
"v" = (
/obj/structure/fluff/railing/wood/west,
/turf/open/floor/rogue/twig,
/area/rogue/indoors/shelter/woods)
"w" = (
/obj/structure/flora/newtree,
/turf/open/floor/rogue/dirt/road,
/area/rogue/indoors/shelter/woods)
"x" = (
/obj/item/reagent_containers/food/snacks/crow,
/turf/open/floor/rogue/rooftop/green/north,
/area/rogue/outdoors/town/roofs)
"y" = (
/obj/structure/stairs{
	dir = 1
	},
/turf/open/floor/rogue/ruinedwood,
/area/rogue/indoors/shelter/woods)
"z" = (
/obj/item/grown/log/tree/stick,
/turf/open/floor/rogue/twig,
/area/rogue/indoors/shelter/woods)
"B" = (
/turf/closed/wall/mineral/rogue/wooddark,
/area/rogue/indoors/shelter/woods)
"C" = (
/obj/structure/fluff/railing/wood/north{
	pixel_y = 1
	},
/obj/structure/fluff/railing/wood/west,
/turf/open/floor/rogue/twig,
/area/rogue/indoors/shelter/woods)
"E" = (
/turf/closed/wall/mineral/rogue/wooddark/vertical,
/area/rogue/indoors/shelter/woods)
"F" = (
/obj/item/chair/stool/bar/rogue/crafted,
/turf/open/floor/rogue/dirt/road,
/area/rogue/indoors/shelter/woods)
"G" = (
/turf/open/floor/rogue/rooftop/green/north,
/area/rogue/outdoors/town/roofs)
"H" = (
/obj/structure/fluff/railing/wood/north{
	pixel_y = 1
	},
/turf/open/floor/rogue/twig,
/area/rogue/indoors/shelter/woods)
"I" = (
/obj/structure/chair/stool/rogue,
/turf/open/floor/rogue/dirt/road,
/area/rogue/indoors/shelter/woods)
"J" = (
/turf/open/floor/rogue/twig,
/area/rogue/indoors/shelter/woods)
"K" = (
/turf/open/transparent/openspace,
/area/rogue/indoors/shelter/woods)
"M" = (
/obj/structure/flora/newtree,
/turf/open/floor/rogue/grass,
/area/rogue/outdoors/woods/south)
"N" = (
/obj/structure/roguewindow,
/turf/open/floor/rogue/ruinedwood/turned,
/area/rogue/indoors/shelter/woods)
"O" = (
/obj/structure/stairs{
	dir = 1
	},
/turf/open/floor/rogue/twig,
/area/rogue/indoors/shelter/woods)
"P" = (
/obj/structure/chair/stool/rogue,
/turf/open/floor/rogue/dirt,
/area/rogue/indoors/shelter/woods)
"Q" = (
/obj/structure/fluff/railing/wood/east,
/turf/open/floor/rogue/twig,
/area/rogue/indoors/shelter/woods)
"R" = (
/turf/open/floor/rogue/dirt,
/area/rogue/outdoors/woods/south)
"S" = (
/turf/closed/wall/mineral/rogue/decowood,
/area/rogue/indoors/shelter/woods)
"T" = (
/turf/open/floor/rogue/ruinedwood,
/area/rogue/indoors/shelter/woods)
"U" = (
/obj/item/reagent_containers/food/snacks/crow{
	dir = 8
	},
/turf/open/floor/rogue/rooftop/green/north,
/area/rogue/outdoors/town/roofs)
"V" = (
/obj/structure/fluff/railing/wood/north{
	pixel_y = 1
	},
/obj/structure/fluff/railing/wood/east,
/turf/open/floor/rogue/twig,
/area/rogue/indoors/shelter/woods)
"X" = (
/turf/closed/wall/mineral/rogue/wooddark/end/north,
/area/rogue/indoors/shelter/woods)
"Z" = (
/obj/item/grown/log/tree/small,
/turf/open/floor/rogue/dirt/road,
/area/rogue/indoors/shelter/woods)

(1,1,1) = {"
b
b
b
M
b
b
b
b
b
b
b
b
b
"}
(2,1,1) = {"
b
b
b
b
B
S
t
S
n
z
S
B
b
"}
(3,1,1) = {"
b
b
b
b
S
P
t
t
t
r
r
S
b
"}
(4,1,1) = {"
b
b
b
R
S
f
t
m
w
r
Z
n
c
"}
(5,1,1) = {"
b
b
b
R
S
P
t
t
r
r
r
z
c
"}
(6,1,1) = {"
b
b
B
v
T
t
t
r
r
r
r
S
c
"}
(7,1,1) = {"
b
J
H
J
T
m
I
s
s
r
T
o
c
"}
(8,1,1) = {"
b
B
J
J
T
T
r
s
s
I
T
S
c
"}
(9,1,1) = {"
b
J
H
J
T
T
r
s
s
T
T
o
c
"}
(10,1,1) = {"
b
b
B
Q
T
T
r
F
r
T
T
S
c
"}
(11,1,1) = {"
b
b
R
b
S
T
T
r
T
h
T
n
R
"}
(12,1,1) = {"
b
b
b
b
S
T
T
T
T
T
T
n
b
"}
(13,1,1) = {"
M
b
b
b
S
X
E
y
T
T
p
S
b
"}
(14,1,1) = {"
M
b
b
b
B
S
S
S
k
n
S
B
b
"}
(15,1,1) = {"
b
b
b
b
b
b
b
b
b
b
b
b
b
"}

(1,1,2) = {"
a
a
a
a
a
a
a
a
a
a
a
a
a
"}
(2,1,2) = {"
a
a
a
a
B
S
S
S
N
N
S
B
a
"}
(3,1,2) = {"
a
a
a
a
S
e
J
J
K
J
J
S
a
"}
(4,1,2) = {"
a
a
a
a
S
J
J
K
K
K
J
S
a
"}
(5,1,2) = {"
a
a
a
a
B
J
J
K
K
K
J
N
a
"}
(6,1,2) = {"
a
a
B
v
d
J
K
K
K
K
J
N
a
"}
(7,1,2) = {"
a
C
J
J
d
J
K
K
K
K
J
S
a
"}
(8,1,2) = {"
a
H
J
J
d
J
K
K
K
K
J
S
a
"}
(9,1,2) = {"
a
V
J
J
d
J
J
K
K
K
J
S
a
"}
(10,1,2) = {"
a
a
B
Q
d
J
K
K
K
K
J
N
a
"}
(11,1,2) = {"
a
a
a
a
B
J
J
K
K
K
J
N
a
"}
(12,1,2) = {"
a
a
a
a
S
J
J
J
J
J
J
S
a
"}
(13,1,2) = {"
a
a
a
a
S
J
O
K
K
J
e
S
a
"}
(14,1,2) = {"
a
a
a
a
B
S
S
S
N
N
S
B
a
"}
(15,1,2) = {"
a
a
a
a
a
a
a
a
a
a
a
a
a
"}

(1,1,3) = {"
a
a
a
a
a
a
a
a
a
a
a
a
a
"}
(2,1,3) = {"
a
a
a
a
G
G
G
G
G
G
G
G
a
"}
(3,1,3) = {"
a
a
a
a
G
G
G
G
G
G
G
G
a
"}
(4,1,3) = {"
a
a
a
a
G
G
G
G
G
G
G
G
a
"}
(5,1,3) = {"
a
a
a
a
G
G
g
g
G
g
G
G
a
"}
(6,1,3) = {"
a
a
G
G
G
x
G
G
G
G
G
G
a
"}
(7,1,3) = {"
a
G
G
G
G
G
G
G
g
G
l
G
a
"}
(8,1,3) = {"
a
G
G
G
G
x
G
G
U
G
l
G
a
"}
(9,1,3) = {"
a
G
G
G
G
G
G
G
G
G
G
G
a
"}
(10,1,3) = {"
a
a
G
G
G
x
G
G
U
U
G
G
a
"}
(11,1,3) = {"
a
a
a
a
G
G
G
G
G
G
G
G
a
"}
(12,1,3) = {"
a
a
a
a
G
G
G
G
G
G
G
G
a
"}
(13,1,3) = {"
a
a
a
a
G
G
G
G
G
G
G
G
a
"}
(14,1,3) = {"
a
a
a
a
G
G
G
G
G
G
G
G
a
"}
(15,1,3) = {"
a
a
a
a
a
a
a
a
a
a
a
a
a
"}
