//MAP CONVERTED BY dmm2tgm.py THIS HEADER COMMENT PREVENTS RECONVERSION, DO NOT REMOVE
"aU" = (
/obj/structure/fluff/railing/border/west{
	layer = 4.3
	},
/turf/open/floor/rogue/dirt,
/area/rogue/outdoors/woods/south)
"aY" = (
/obj/item/reagent_containers/glass/cup/wooden,
/obj/structure/table/wood/poor,
/turf/open/floor/rogue/blocks/stonered/tiny,
/area/rogue/indoors)
"by" = (
/turf/open/floor/rogue/dirt,
/area/rogue/outdoors/woods/south)
"bJ" = (
/obj/structure/fluff/railing/wood/east,
/turf/open/floor/rogue/twig,
/area/rogue/indoors)
"bW" = (
/turf/closed/wall/mineral/rogue/wooddark/vertical,
/area/rogue/indoors)
"cM" = (
/obj/structure/flora/roguegrass,
/obj/structure/fluff/railing/border/west{
	dir = 6
	},
/turf/open/floor/rogue/grass,
/area/rogue/outdoors/woods/south)
"cU" = (
/obj/effect/decal/cleanable/dirt/cobweb{
	dir = 1
	},
/obj/effect/decal/remains/human,
/turf/open/floor/rogue/blocks/stonered/tiny,
/area/rogue/indoors)
"dU" = (
/obj/item/reagent_containers/food/snacks/crow{
	dir = 8;
	pixel_y = 12;
	pixel_x = 6
	},
/turf/open/floor/rogue/rooftop/green/north,
/area/rogue/outdoors/town/roofs)
"ew" = (
/obj/structure/table/wood/map/three,
/obj/effect/decal/cleanable/debris/woody,
/turf/open/floor/rogue/blocks/stonered/tiny,
/area/rogue/indoors)
"fB" = (
/obj/item/reagent_containers/food/snacks/crow,
/turf/open/floor/rogue/rooftop/green/north,
/area/rogue/outdoors/town/roofs)
"gj" = (
/turf/open/floor/rogue/grass,
/area/rogue/outdoors/woods/south)
"gN" = (
/obj/machinery/light/rogue/candle/r,
/turf/open/floor/rogue/blocks/stonered/tiny,
/area/rogue/indoors)
"hE" = (
/obj/effect/decal/cleanable/blood/footprints/mud,
/turf/open/floor/rogue/dirt/road,
/area/rogue/outdoors/woods/south)
"iZ" = (
/obj/structure/wallladder,
/turf/open/transparent/openspace,
/area/rogue/outdoors/mountains)
"kk" = (
/obj/structure/bed/rogue{
	dir = 8
	},
/mob/living/carbon/human/species/skeleton/npc/supereasy,
/turf/open/floor/rogue/blocks/stonered/tiny,
/area/rogue/indoors)
"kW" = (
/obj/machinery/light/rogue/candle/weak/l,
/turf/open/floor/rogue/blocks/stonered/tiny,
/area/rogue/indoors)
"le" = (
/obj/machinery/light/rogue/candle/r,
/obj/structure/closet/crate/chest/wicker,
/obj/effect/decal/cleanable/debris/stony,
/turf/open/floor/rogue/blocks/stonered/tiny,
/area/rogue/indoors)
"lX" = (
/obj/structure/flora/roguegrass/bush/westleach,
/turf/open/floor/rogue/grass,
/area/rogue/outdoors/woods/south)
"mb" = (
/obj/structure/toilet,
/obj/item/natural/cloth{
	pixel_x = -8
	},
/obj/effect/decal/cleanable/dirt/cobweb{
	dir = 1
	},
/turf/open/floor/rogue/blocks/stonered/tiny,
/area/rogue/indoors)
"mi" = (
/turf/closed/wall/mineral/rogue/wooddark/end/west,
/area/rogue/indoors)
"mu" = (
/obj/structure/fluff/railing/border/west{
	layer = 4.3
	},
/turf/open/floor/rogue/grass,
/area/rogue/outdoors/woods/south)
"nC" = (
/obj/structure/table/wood/map/four,
/obj/effect/decal/cleanable/dirt/cobweb{
	dir = 8
	},
/obj/effect/decal/cleanable/debris/woody,
/obj/effect/decal/cleanable/debris/stony,
/turf/open/floor/rogue/blocks/stonered/tiny,
/area/rogue/indoors)
"nD" = (
/obj/item/seeds/wheat,
/turf/open/floor/rogue/rooftop/green/north,
/area/rogue/outdoors/town/roofs)
"of" = (
/obj/structure/flora/roguegrass/bush/westleach,
/obj/structure/fluff/railing/border/west{
	dir = 4
	},
/obj/structure/fluff/railing/border,
/obj/structure/fluff/railing/border/west{
	dir = 6
	},
/turf/open/floor/rogue/grass,
/area/rogue/outdoors/woods/south)
"og" = (
/obj/structure/closet/crate/chest/neu,
/turf/open/floor/rogue/blocks/stonered/tiny,
/area/rogue/indoors)
"oF" = (
/obj/structure/mineral_door/wood/deadbolt{
	color = "#778079";
	dir = 1;
	max_integrity = 500;
	name = "rotting door"
	},
/turf/open/floor/rogue/blocks/stonered,
/area/rogue/indoors)
"pC" = (
/obj/structure/stairs{
	dir = 1
	},
/turf/open/floor/rogue/twig,
/area/rogue/indoors)
"qp" = (
/obj/machinery/light/rogue/candle/l,
/turf/open/floor/rogue/blocks/stonered/tiny,
/area/rogue/indoors)
"rv" = (
/turf/open/floor/rogue/rooftop/green/north,
/area/rogue/outdoors/town/roofs)
"rz" = (
/turf/closed/wall/mineral/rogue/wooddark/end/north,
/area/rogue/indoors)
"sE" = (
/obj/machinery/light/rogue/candle/l,
/obj/effect/decal/cleanable/dirt/cobweb,
/turf/open/floor/rogue/blocks/stonered/tiny,
/area/rogue/indoors)
"tt" = (
/obj/effect/decal/cleanable/dirt/cobweb/cobweb2,
/turf/open/floor/rogue/blocks/stonered/tiny,
/area/rogue/indoors)
"tz" = (
/obj/structure/mineral_door/wood/deadbolt{
	dir = 8;
	locked = 1;
	name = "rotting door";
	color = "#778079";
	max_integrity = 500
	},
/turf/open/floor/rogue/blocks/stonered,
/area/rogue/indoors)
"uU" = (
/turf/closed/wall/mineral/rogue/wooddark,
/area/rogue/indoors)
"uW" = (
/obj/structure/fluff/railing/border/west{
	dir = 2
	},
/turf/open/floor/rogue/grass,
/area/rogue/outdoors/woods/south)
"wo" = (
/obj/structure/table/wood/map/two,
/obj/effect/decal/cleanable/dirt/cobweb,
/obj/effect/decal/cleanable/debris/woody,
/obj/effect/decal/cleanable/debris/stony,
/turf/open/floor/rogue/blocks/stonered,
/area/rogue/indoors)
"wD" = (
/obj/effect/decal/cleanable/dirt/cobweb{
	dir = 1
	},
/turf/open/floor/rogue/blocks/stonered/tiny,
/area/rogue/indoors)
"wX" = (
/obj/structure/mineral_door/wood/deadbolt{
	dir = 1;
	locked = 1;
	name = "rotting door";
	color = "#778079";
	max_integrity = 500
	},
/turf/open/floor/rogue/blocks/stonered,
/area/rogue/indoors)
"xR" = (
/obj/structure/bed/rogue{
	dir = 8
	},
/turf/open/floor/rogue/blocks/stonered/tiny,
/area/rogue/indoors)
"xW" = (
/obj/structure/closet/crate/chest/neu_iron,
/turf/open/floor/rogue/blocks/stonered/tiny,
/area/rogue/indoors)
"zb" = (
/mob/living/carbon/human/species/skeleton/npc/mediumspread,
/obj/structure/chair/stool/rogue,
/obj/effect/decal/cleanable/blood/footprints/mud,
/turf/open/floor/rogue/blocks/stonered,
/area/rogue/indoors)
"zO" = (
/obj/structure/table/wood/map,
/obj/effect/decal/cleanable/dirt/cobweb{
	dir = 1
	},
/turf/open/floor/rogue/blocks/stonered/tiny,
/area/rogue/indoors)
"An" = (
/obj/effect/decal/remains/human,
/obj/effect/landmark/quest_spawner/easy,
/turf/open/floor/rogue/blocks/stonered,
/area/rogue/indoors)
"Aw" = (
/obj/structure/fluff/railing/wood/north{
	pixel_y = 1
	},
/obj/structure/fluff/railing/wood/east,
/turf/open/floor/rogue/twig,
/area/rogue/indoors)
"Br" = (
/turf/closed/wall/mineral/rogue/wooddark/end/east,
/area/rogue/indoors)
"Db" = (
/obj/item/chair/stool/bar/rogue,
/turf/open/floor/rogue/blocks/stonered/tiny,
/area/rogue/indoors)
"Dn" = (
/obj/structure/rack/rogue,
/obj/effect/spawner/lootdrop/general_loot_low,
/turf/open/floor/rogue/blocks/stonered/tiny,
/area/rogue/indoors)
"Ek" = (
/obj/structure/fluff/railing/border/west{
	dir = 4
	},
/turf/open/floor/rogue/grass,
/area/rogue/outdoors/woods/south)
"Ep" = (
/obj/item/reagent_containers/food/snacks/crow{
	dir = 4
	},
/turf/open/floor/rogue/rooftop/green/north,
/area/rogue/outdoors/town/roofs)
"EH" = (
/turf/open/floor/rogue/dirt/road,
/area/rogue/outdoors/woods/south)
"Fc" = (
/obj/effect/decal/cleanable/blood/footprints/mud{
	dir = 8
	},
/turf/open/floor/rogue/blocks/stonered/tiny,
/area/rogue/indoors)
"Fi" = (
/obj/structure/flora/newtree,
/turf/open/floor/rogue/grass,
/area/rogue/outdoors/woods/south)
"Fl" = (
/obj/effect/decal/cleanable/dirt/cobweb{
	dir = 8
	},
/turf/open/floor/rogue/blocks/stonered/tiny,
/area/rogue/indoors)
"Fv" = (
/mob/living/carbon/human/species/skeleton/npc/supereasy,
/turf/open/floor/rogue/blocks/stonered/tiny,
/area/rogue/indoors)
"FW" = (
/turf/open/floor/rogue/blocks/stonered,
/area/rogue/indoors)
"Gm" = (
/obj/item/cigbutt/roach{
	pixel_y = 1;
	pixel_x = -6
	},
/obj/item/ash,
/turf/open/floor/rogue/blocks/stonered/tiny,
/area/rogue/indoors)
"GS" = (
/obj/structure/fluff/railing/wood/north{
	pixel_y = 1
	},
/turf/open/floor/rogue/twig,
/area/rogue/indoors)
"GV" = (
/turf/open/floor/rogue/blocks/stonered/tiny,
/area/rogue/indoors)
"GZ" = (
/obj/structure/fluff/railing/wood/west,
/turf/open/floor/rogue/twig,
/area/rogue/indoors)
"Hb" = (
/obj/structure/table/wood/map/six,
/obj/item/ash,
/obj/item/cigbutt/roach{
	pixel_y = 1;
	pixel_x = -6
	},
/turf/open/floor/rogue/blocks/stonered/tiny,
/area/rogue/indoors)
"Hf" = (
/obj/structure/table/wood/map/five,
/obj/effect/decal/cleanable/dirt/cobweb{
	dir = 4
	},
/obj/machinery/light/rogue/candle,
/turf/open/floor/rogue/blocks/stonered/tiny,
/area/rogue/indoors)
"HS" = (
/obj/structure/mineral_door/wood/deadbolt{
	dir = 4;
	locked = 1;
	name = "rotting door";
	color = "#778079";
	max_integrity = 500
	},
/turf/open/floor/rogue/blocks/stonered,
/area/rogue/indoors)
"Id" = (
/obj/machinery/light/rogue/candle,
/obj/effect/decal/cleanable/dirt/cobweb{
	dir = 8
	},
/turf/open/floor/rogue/blocks/stonered/tiny,
/area/rogue/indoors)
"JF" = (
/turf/open/floor/rogue/twig,
/area/rogue/indoors)
"JZ" = (
/obj/structure/stairs{
	dir = 1
	},
/turf/open/floor/rogue/blocks/stonered,
/area/rogue/indoors)
"KH" = (
/obj/effect/landmark/quest_spawner/medium,
/turf/open/floor/rogue/blocks/stonered/tiny,
/area/rogue/indoors)
"Lh" = (
/obj/structure/flora/roguegrass,
/obj/structure/fluff/railing/border/west{
	dir = 4
	},
/turf/open/floor/rogue/dirt,
/area/rogue/outdoors/woods/south)
"LD" = (
/obj/structure/fluff/railing/border/west{
	dir = 10
	},
/turf/open/floor/rogue/grass,
/area/rogue/outdoors/woods/south)
"LJ" = (
/obj/structure/flora/roguegrass,
/turf/open/floor/rogue/grass,
/area/rogue/outdoors/woods/south)
"LP" = (
/obj/structure/closet/crate/chest/wicker,
/obj/effect/decal/cleanable/dirt/cobweb{
	dir = 1
	},
/turf/open/floor/rogue/blocks/stonered/tiny,
/area/rogue/indoors)
"LY" = (
/obj/item/ash{
	pixel_x = -16;
	pixel_y = -4
	},
/obj/item/cigbutt/roach{
	pixel_x = -21
	},
/turf/open/floor/rogue/blocks/stonered,
/area/rogue/indoors)
"Mf" = (
/turf/open/transparent/openspace,
/area/rogue/outdoors/mountains)
"Mt" = (
/obj/structure/bed/rogue{
	dir = 8
	},
/obj/effect/decal/cleanable/dirt/cobweb,
/turf/open/floor/rogue/blocks/stonered/tiny,
/area/rogue/indoors)
"MO" = (
/obj/effect/decal/cleanable/blood/footprints/mud,
/obj/effect/decal/cleanable/blood/footprints/mud{
	dir = 8
	},
/turf/open/floor/rogue/blocks/stonered/tiny,
/area/rogue/indoors)
"Nh" = (
/obj/machinery/light/rogue/candle/weak/r,
/turf/open/floor/rogue/blocks/stonered/tiny,
/area/rogue/indoors)
"NO" = (
/turf/closed/wall/mineral/rogue/stonebrick,
/area/rogue/indoors)
"Oq" = (
/obj/structure/mineral_door/wood/deadbolt{
	dir = 1;
	locked = 1;
	name = "rotting door";
	color = "#778079";
	max_integrity = 500
	},
/obj/effect/decal/cleanable/blood/footprints/mud,
/turf/open/floor/rogue/blocks/stonered,
/area/rogue/indoors)
"Pk" = (
/turf/closed/wall/mineral/rogue/wooddark/end,
/area/rogue/indoors)
"PH" = (
/obj/structure/fluff/railing/border/west{
	dir = 6
	},
/turf/open/floor/rogue/grass,
/area/rogue/outdoors/woods/south)
"PY" = (
/obj/structure/flora/roguegrass/bush/wall/tall,
/turf/open/floor/rogue/grass,
/area/rogue/outdoors/woods/south)
"Qj" = (
/obj/structure/mineral_door/wood/deadbolt{
	dir = 8;
	locked = 1;
	name = "rotting door";
	color = "#778079"
	},
/turf/open/floor/rogue/blocks/stonered/tiny,
/area/rogue/indoors)
"Rq" = (
/obj/effect/decal/cleanable/blood/footprints/mud,
/turf/open/floor/rogue/blocks/stonered,
/area/rogue/indoors)
"Si" = (
/obj/structure/flora/roguegrass/bush,
/turf/open/floor/rogue/grass,
/area/rogue/outdoors/woods/south)
"Sr" = (
/obj/structure/closet/crate/chest/wicker,
/turf/open/floor/rogue/blocks/stonered/tiny,
/area/rogue/indoors)
"SL" = (
/obj/effect/decal/remains/human,
/turf/open/floor/rogue/blocks/stonered/tiny,
/area/rogue/indoors)
"TZ" = (
/obj/structure/fluff/railing/border,
/obj/structure/fluff/railing/border/west,
/obj/structure/fluff/railing/border/west{
	dir = 10
	},
/turf/open/floor/rogue/grass,
/area/rogue/outdoors/woods/south)
"Ui" = (
/obj/effect/decal/cleanable/dirt/cobweb{
	dir = 4
	},
/obj/structure/closet/crate/chest/neu,
/turf/open/floor/rogue/blocks/stonered/tiny,
/area/rogue/indoors)
"Uz" = (
/turf/closed/wall/mineral/rogue/wooddark/window,
/area/rogue/indoors)
"UQ" = (
/obj/structure/fluff/railing/wood/north{
	pixel_y = 1
	},
/obj/structure/fluff/railing/wood/west,
/turf/open/floor/rogue/twig,
/area/rogue/indoors)
"Vb" = (
/obj/effect/decal/cleanable/dirt/cobweb{
	dir = 8
	},
/turf/open/transparent/openspace,
/area/rogue/indoors)
"Xf" = (
/obj/structure/rack/rogue,
/obj/item/storage/belt/rogue/pouch/zigarrete,
/turf/open/floor/rogue/blocks/stonered/tiny,
/area/rogue/indoors)
"XL" = (
/obj/item/reagent_containers/food/snacks/crow{
	dir = 8
	},
/turf/open/floor/rogue/rooftop/green/north,
/area/rogue/outdoors/town/roofs)
"XP" = (
/obj/structure/wallladder,
/turf/open/floor/rogue/grass,
/area/rogue/outdoors/woods/south)
"YJ" = (
/obj/item/reagent_containers/food/snacks/crow{
	dir = 1
	},
/turf/open/floor/rogue/rooftop/green/north,
/area/rogue/outdoors/town/roofs)
"Zn" = (
/obj/structure/chair/wood/rogue/chair4{
	dir = 1
	},
/turf/open/floor/rogue/twig,
/area/rogue/indoors)
"Zv" = (
/obj/effect/decal/cleanable/dirt/cobweb{
	dir = 4
	},
/turf/open/floor/rogue/blocks/stonered/tiny,
/area/rogue/indoors)
"ZO" = (
/obj/structure/mineral_door/wood/deadbolt{
	dir = 4;
	locked = 1;
	name = "rotting door";
	color = "#778079";
	max_integrity = 500
	},
/turf/open/floor/rogue/blocks/stonered/tiny,
/area/rogue/indoors)

(1,1,1) = {"
gj
Fi
gj
Fi
gj
gj
gj
gj
Fi
gj
lX
gj
Fi
"}
(2,1,1) = {"
Fi
gj
gj
LJ
uU
NO
NO
uU
Uz
Uz
NO
uU
gj
"}
(3,1,1) = {"
gj
gj
gj
Si
NO
qp
GV
oF
GV
SL
Zv
NO
LJ
"}
(4,1,1) = {"
Fi
gj
Fi
by
NO
mb
Fv
Br
LP
le
GV
Uz
EH
"}
(5,1,1) = {"
gj
cM
Ek
Lh
uU
NO
NO
NO
NO
rz
tz
uU
EH
"}
(6,1,1) = {"
PH
of
Uz
Uz
Br
GV
GV
qp
GV
GV
GV
Br
EH
"}
(7,1,1) = {"
uW
Uz
nC
zO
GV
Db
FW
FW
FW
FW
GV
wX
EH
"}
(8,1,1) = {"
uW
uU
Hf
wo
zb
Rq
FW
An
FW
FW
GV
uU
EH
"}
(9,1,1) = {"
uW
Uz
Hb
ew
Db
GV
FW
FW
Rq
Rq
MO
Oq
hE
"}
(10,1,1) = {"
LD
TZ
Uz
Uz
mi
tt
GV
gN
Fl
wD
Fc
mi
EH
"}
(11,1,1) = {"
Fi
LD
aU
mu
uU
NO
NO
NO
NO
rz
HS
uU
by
"}
(12,1,1) = {"
gj
LJ
LJ
PY
NO
NO
NO
NO
sE
GV
GV
Uz
PY
"}
(13,1,1) = {"
Fi
Si
LJ
XP
NO
rz
bW
JZ
GV
GV
Sr
NO
Fi
"}
(14,1,1) = {"
Fi
Fi
gj
gj
uU
NO
NO
NO
Uz
Uz
NO
uU
gj
"}
(15,1,1) = {"
gj
gj
gj
Fi
gj
gj
lX
LJ
gj
LJ
gj
gj
LJ
"}

(1,1,2) = {"
Mf
Mf
Mf
Mf
Mf
Mf
Mf
Mf
Mf
Mf
Mf
Mf
Mf
"}
(2,1,2) = {"
Mf
Mf
Mf
Mf
uU
NO
Uz
NO
Uz
NO
NO
uU
Mf
"}
(3,1,2) = {"
Mf
Mf
Mf
Mf
NO
Mt
GV
kk
GV
xR
kW
NO
Mf
"}
(4,1,2) = {"
Mf
Mf
Mf
Mf
NO
Ui
GV
og
GV
Ui
SL
NO
Mf
"}
(5,1,2) = {"
Mf
Mf
Mf
Mf
uU
Id
GV
KH
GV
GV
GV
NO
Mf
"}
(6,1,2) = {"
Mf
Mf
uU
GZ
NO
xR
GV
xR
GV
kk
GV
NO
Mf
"}
(7,1,2) = {"
Mf
UQ
Zn
FW
mi
xW
GV
xW
SL
xW
GV
Uz
Mf
"}
(8,1,2) = {"
Mf
GS
LY
FW
wX
GV
GV
GV
GV
GV
GV
NO
Mf
"}
(9,1,2) = {"
Mf
Aw
JF
FW
Br
GV
GV
GV
Nh
GV
Fl
Uz
Mf
"}
(10,1,2) = {"
Mf
Mf
uU
bJ
NO
GV
GV
aY
rz
ZO
Pk
NO
Mf
"}
(11,1,2) = {"
Mf
Mf
Mf
Mf
uU
Qj
Pk
NO
NO
Gm
Xf
NO
Mf
"}
(12,1,2) = {"
Mf
Mf
Mf
Mf
NO
GV
GV
GV
NO
GV
Dn
NO
Mf
"}
(13,1,2) = {"
Mf
Mf
Mf
iZ
NO
GV
pC
Vb
NO
cU
Dn
NO
Mf
"}
(14,1,2) = {"
Mf
Mf
Mf
Mf
uU
NO
NO
NO
Uz
Uz
NO
uU
Mf
"}
(15,1,2) = {"
Mf
Mf
Mf
Mf
Mf
Mf
Mf
Mf
Mf
Mf
Mf
Mf
Mf
"}

(1,1,3) = {"
Mf
Mf
Mf
Mf
Mf
Mf
Mf
Mf
Mf
Mf
Mf
Mf
Mf
"}
(2,1,3) = {"
Mf
Mf
Mf
Mf
rv
rv
rv
rv
rv
rv
rv
rv
Mf
"}
(3,1,3) = {"
Mf
Mf
Mf
Mf
rv
rv
rv
rv
rv
rv
rv
rv
Mf
"}
(4,1,3) = {"
Mf
Mf
Mf
Mf
rv
rv
rv
fB
rv
rv
rv
rv
Mf
"}
(5,1,3) = {"
Mf
Mf
Mf
Mf
rv
rv
rv
rv
Ep
rv
rv
rv
Mf
"}
(6,1,3) = {"
Mf
Mf
rv
rv
rv
fB
fB
rv
nD
Ep
rv
rv
Mf
"}
(7,1,3) = {"
Mf
rv
rv
rv
rv
rv
nD
rv
rv
fB
rv
rv
Mf
"}
(8,1,3) = {"
Mf
rv
rv
rv
rv
rv
rv
rv
rv
XL
nD
rv
Mf
"}
(9,1,3) = {"
Mf
rv
rv
rv
fB
fB
fB
nD
rv
YJ
rv
rv
Mf
"}
(10,1,3) = {"
Mf
Mf
rv
rv
rv
rv
rv
rv
rv
dU
rv
rv
Mf
"}
(11,1,3) = {"
Mf
Mf
Mf
Mf
rv
rv
rv
rv
dU
rv
rv
rv
Mf
"}
(12,1,3) = {"
Mf
Mf
Mf
Mf
rv
rv
rv
rv
rv
rv
rv
rv
Mf
"}
(13,1,3) = {"
Mf
Mf
Mf
iZ
rv
rv
rv
rv
rv
rv
rv
rv
Mf
"}
(14,1,3) = {"
Mf
Mf
Mf
Mf
rv
rv
rv
rv
rv
rv
rv
fB
Mf
"}
(15,1,3) = {"
Mf
Mf
Mf
Mf
Mf
Mf
Mf
Mf
Mf
Mf
Mf
Mf
Mf
"}
